돼지고기메추리알장조림: ['깍둑돼지고기메추리알장조림', '돼지고기메추리알장조림', '찢은돼지고기메추리알장조림']
해물토마토소스스파게티: ['해물토마토소스스파게티']
두부쇠고기고추장찌개: ['두부쇠고기고추장찌개']
쇠고기메추리알장조림: ['쇠고기메추리알장조림', '한우쇠고기메추리알장조림']
미트볼토마토스파게티: ['미트볼토마토스파게티볶음']
소고기메추리알장조림: ['마늘소고기메추리알장조림', '소고기메추리알장조림']
고추장불고기삼각김밥: ['고추장불고기삼각김밥']
해물크림소스스파게티: ['해물크림소스스파게티']
잔멸치꽈리고추볶음: ['잔멸치꽈리고추볶음']
콩나물고춧가루무침: ['콩나물고춧가루무침']
고구마줄기나물무침: ['고구마줄기나물무침']
고추장마늘쫑장아찌: ['고추장마늘쫑장아찌']
토마토소스스파게티: ['토마토소스스파게티볶음']
돼지고기김치찌개: ['돼지고기김치찌개', '모듬부위돼지고기김치찌개', '콩비지돼지고기김치찌개']
두릅초고추장무침: ['두릅초고추장무침']
닭가슴살샌드위치: ['닭가슴살샌드위치']
잔멸치풋고추볶음: ['잔멸치풋고추볶음']
잔멸치견과류볶음: ['잔멸치견과류볶음']
쇠고기고추장볶음: ['쇠고기고추장볶음양념']
묵은지삼겹살볶음: ['묵은지삼겹살볶음']
마늘쫑잔멸치볶음: ['마늘쫑잔멸치볶음']
돼지고기채소볶음: ['돼지고기채소볶음']
돼지고기김치볶음: ['돼지고기김치볶음', '돼지고기김치볶음밥', '온두부돼지고기김치볶음', '훈제돼지고기김치볶음']
꽈리고추멸치볶음: ['꽈리고추멸치볶음', '매콤꽈리고추멸치볶음', '문어꽈리고추멸치볶음', '얼큰꽈리고추멸치볶음', '친환경꽈리고추멸치볶음']
참치마요삼각김밥: ['김치참치마요삼각김밥', '날치알참치마요삼각김밥', '수제참치마요삼각김밥', '스팸참치마요삼각김밥', '전주비빔참치마요삼각김밥', '참치마요삼각김밥', '통햄구이참치마요삼각김밥']
열무된장나물무침: ['열무된장나물무침', '음열무된장나물무침']
삼겹살고추장구이: ['삼겹살고추장구이와']
간장마늘쫑장아찌: ['간장마늘쫑장아찌']
숯불갈비삼각김밥: ['매콤숯불갈비삼각김밥']
크림소스스파게티: ['날치알크림소스스파게티', '매콤크림소스스파게티', '빠네크림소스스파게티', '청양크림소스스파게티']
호박고추장찌개: ['감자애호박고추장찌개', '감자호박고추장찌개', '건새우호박고추장찌개', '꽁치감자호박고추장찌개', '느타리호박고추장찌개', '단호박고추장찌개', '닭고기감자호박고추장찌개', '돈육감자호박고추장찌개', '돈육애호박고추장찌개', '돈육호박고추장찌개', '돈호박고추장찌개', '돼지고기호박고추장찌개', '두부호박고추장찌개', '목살감자호박고추장찌개', '목살애호박고추장찌개', '사태호박고추장찌개', '삼겹살호박고추장찌개', '새우살호박고추장찌개', '생새우호박고추장찌개', '쇠고기애호박고추장찌개', '쇠고기호박고추장찌개', '스팸애호박고추장찌개', '애호박고추장찌개', '애호박호박고추장찌개', '어묵호박고추장찌개', '얼큰호박고추장찌개', '차돌박이감자호박고추장찌개', '차돌호박고추장찌개', '참치감자애호박고추장찌개', '참치감자호박고추장찌개', '참치애호박고추장찌개', '참치호박고추장찌개', '친환경돈육호박고추장찌개', '친환경호박고추장찌개', '한우호박고추장찌개', '호박고추장찌개']
콩나물된장찌개: ['모듬버섯콩나물된장찌개', '북어콩나물된장찌개', '콩나물된장찌개']
순두부김치찌개: ['돈육순두부김치찌개', '돼지고기순두부김치찌개', '몽글순두부김치찌개', '바지락살순두부김치찌개', '바지락순두부김치찌개', '삼겹살순두부김치찌개', '순두부김치찌개', '참치순두부김치찌개', '해물순두부김치찌개']
쇠고기된장찌개: ['쇠고기된장찌개', '차돌쇠고기된장찌개']
쇠고기샤브샤브: ['쇠고기샤브샤브국수']
두부고추장찌개: ['감자두부고추장찌개', '감자야채두부고추장찌개', '감자호박두부고추장찌개', '돈육두부고추장찌개', '돈육순두부고추장찌개', '두부고추장찌개', '버섯두부고추장찌개', '북어두부고추장찌개', '북어포두부고추장찌개', '순두부고추장찌개', '애호박두부고추장찌개', '연두부고추장찌개', '오징어두부고추장찌개', '참치두부고추장찌개', '햄소시지두부고추장찌개', '호박두부고추장찌개']
메추리알장조림: ['간장메추리알장조림', '감자메추리알장조림', '고기메추리알장조림', '고추메추리알장조림', '고추장메추리알장조림', '곤약메추리알장조림', '깐메추리알장조림', '꼬마새송이메추리알장조림', '꽈리고추돈육메추리알장조림', '꽈리고추메추리알장조림', '꽈리돈육메추리알장조림', '꽈리메추리알장조림', '꽈리초메추리알장조림', '네모어묵메추리알장조림', '네모참치메추리알장조림', '다시마메추리알장조림', '달콤새송이메추리알장조림', '닭가슴메추리알장조림', '닭가슴살메추리알장조림', '닭고기메추리알장조림', '닭메추리알장조림', '닭봉메추리알장조림', '닭살메추리알장조림', '닭안심메추리알장조림', '돈메추리알장조림', '돈사태메추리알장조림', '돈안심메추리알장조림', '돈욱안심메추리알장조림', '돈육감자메추리알장조림', '돈육곤약메추리알장조림', '돈육꽈리고추메추리알장조림', '돈육꽈리메추리알장조림', '돈육메추리알장조림', '돈육사태메추리알장조림', '돈육새송이메추리알장조림', '돈육안심메추리알장조림', '돈육자장메추리알장조림', '돈육조랭이떡메추리알장조림', '돈육표고메추리알장조림', '돈채메추리알장조림', '돼지메추리알장조림', '두부메추리알장조림', '등심메추리알장조림', '마늘쫑메추리알장조림', '마약메추리알장조림', '만두메추리알장조림', '매운돈육메추리알장조림', '매운메추리알장조림', '매운어묵메추리알장조림', '매콤돈사태메추리알장조림', '매콤돈육메추리알장조림', '매콤메추리알장조림', '매콤새송이메추리알장조림', '메기메추리알장조림', '메추리알장조림', '모둠메추리알장조림', '모듬메추리알장조림', '모듬버섯메추리알장조림', '문어메추리알장조림', '미니새송이메추리알장조림', '미트볼메추리알장조림', '버섯돈육메추리알장조림', '버섯메추리알장조림', '볼어묵메추리알장조림', '비엔나메추리알장조림', '비엔나소시지메추리알장조림', '빨강돈육메추리알장조림', '사태메추리알장조림', '삼색메추리알장조림', '새송이돈육메추리알장조림', '새송이메추리알장조림', '새송이버섯메추리알장조림', '색메추리알장조림', '소세지메추리알장조림', '소시지메추리알장조림', '소이메추리알장조림', '스팸메추리알장조림', '아기고추메추리알장조림', '안심과메추리알장조림', '안심메추리알장조림', '알감자메추리알장조림', '애새송이메추리알장조림', '양송이메추리알장조림', '양파송송메추리알장조림', '어묵메추리알장조림', '연곤약메추리알장조림', '연근메추리알장조림', '오징어메추리알장조림', '오징어어묵메추리알장조림', '우사태메추리알장조림', '우엉메추리알장조림', '전복메추리알장조림', '제육메추리알장조림', '중화메추리알장조림', '찢은돈육메추리알장조림', '찢은메추리알장조림', '참치메추리알장조림', '채식스테이크메추리알장조림', '청량초메추리알장조림', '친환경메추리알장조림', '카레향메추리알장조림', '큐브참치메추리알장조림', '통마늘메추리알장조림', '포크폴드메추리알장조림', '표고메추리알장조림', '표고버섯메추리알장조림', '풋고추메추리알장조림', '프랑크메추리알장조림', '한돈메추리알장조림', '한돈안심메추리알장조림', '한우메추리알장조림', '햄메추리알장조림']
돼지고기장조림: ['돼지고기장조림덮밥']
스크램블드에그: ['스크램블드에그덮밥']
돼지고기완자전: ['돼지고기완자전']
풋고추된장무침: ['아삭풋고추된장무침', '오이풋고추된장무침', '풋고추된장무침']
오징어채소무침: ['갑오징어채소무침', '골뱅이오징어채소무침', '물오징어채소무침', '반건조오징어채소무침', '베이비갑오징어채소무침', '오징어채소무침']
새싹채소샐러드: ['모듬묵새싹채소샐러드', '새싹채소샐러드']
도라지오이생채: ['달래도라지오이생채', '도라지오이생채', '사과도라지오이생채', '오징어도라지오이생채']
닭가슴살샐러드: ['닭가슴살샐러드새우젓시저소스']
느타리버섯무침: ['구운느타리버섯무침', '느타리버섯무침', '돌나물느타리버섯무침', '들깨느타리버섯무침', '부추느타리버섯무침', '숙주느타리버섯무침', '쑥갓느타리버섯무침', '쑥갓애느타리버섯무침', '애느타리버섯무침', '애호박느타리버섯무침', '오이느타리버섯무침', '잔파느타리버섯무침', '잔파애느타리버섯무침', '풋마늘느타리버섯무침', '한재미나리느타리버섯무침']
골뱅이국수무침: ['골뱅이국수무침']
햄치즈샌드위치: ['감자샐러드햄치즈샌드위치', '군서수제햄치즈샌드위치', '달콤햄치즈샌드위치', '대만식햄치즈샌드위치', '대만햄치즈샌드위치', '미니햄치즈샌드위치', '복음자리햄치즈샌드위치', '부쉬맨햄치즈샌드위치', '블루베리햄치즈샌드위치', '삼각햄치즈샌드위치', '수제대만식햄치즈샌드위치', '수제모닝빵햄치즈샌드위치', '수제햄치즈샌드위치', '스위트햄치즈샌드위치', '식빵햄치즈샌드위치', '에그햄치즈샌드위치', '크로플햄치즈샌드위치', '토마토햄치즈샌드위치', '통밀햄치즈샌드위치', '한입햄치즈샌드위치', '햄치즈샌드위치', '호밀햄치즈샌드위치', '홍루이젠햄치즈샌드위치']
콤비네이션피자: ['치즈콤비네이션피자조각', '콤비네이션피자한쪽']
멸치풋고추볶음: ['멸치풋고추볶음', '어묵멸치풋고추볶음', '혼견과류합멸치풋고추볶음', '혼합멸치풋고추볶음']
잔멸치고추볶음: ['잔멸치고추볶음']
쇠고기채소볶음: ['쇠고기채소볶음', '우엉쇠고기채소볶음밥', '친환경쌀쇠고기채소볶음밥']
쇠고기버섯볶음: ['쇠고기버섯볶음', '쇠고기버섯볶음우동']
새송이버섯볶음: ['새송이버섯볶음여']
멸치마늘쫑볶음: ['견과류멸치마늘쫑볶음', '고추장멸치마늘쫑볶음', '깐멸치마늘쫑볶음', '매콤멸치마늘쫑볶음', '멸치마늘쫑볶음', '잔멸치마늘쫑볶음', '저염멸치마늘쫑볶음']
멸치견과류볶음: ['매콤저염멸치견과류볶음', '멸치견과류볶음', '자반멸치견과류볶음', '저염멸치견과류볶음', '지리멸치견과류볶음', '혼합멸치견과류볶음']
느타리버섯볶음: ['가지느타리버섯볶음', '가지애느타리버섯볶음', '게맛살느타리버섯볶음', '게맛살채느타리버섯볶음', '고기느타리버섯볶음', '고사리느타리버섯볶음', '곤드레느타리버섯볶음', '곤드레애느타리버섯볶음', '굴소스느타리버섯볶음', '그린빈느타리버섯볶음', '꽃맛살느타리버섯볶음', '꽈리고추느타리버섯볶음', '느타리버섯볶음', '닭살애느타리버섯볶음', '대파느타리버섯볶음', '돈육느타리버섯볶음', '들깨가루애느타리버섯볶음', '들깨느타리버섯볶음', '들깨애느타리버섯볶음', '들깨애호박느타리버섯볶음', '마늘쫑애느타리버섯볶음', '맛살느타리버섯볶음', '매운느타리버섯볶음', '매콤느타리버섯볶음', '매콤애느타리버섯볶음', '무농약애느타리버섯볶음', '베이컨느타리버섯볶음', '부여느타리버섯볶음', '부추느타리버섯볶음', '브로컬리느타리버섯볶음', '브로콜리느타리버섯볶음', '비엔나느타리버섯볶음', '비엔나애느타리버섯볶음', '새송이느타리버섯볶음', '새우젓애호박느타리버섯볶음', '쇠고기느타리버섯볶음', '쇠고기애느타리버섯볶음', '숙주나물느타리버섯볶음', '쑥갓애느타리버섯볶음', '애기느타리버섯볶음', '애느타리버섯볶음', '애호박느타리버섯볶음', '애호박애느타리버섯볶음', '양평느타리버섯볶음', '어묵느타리버섯볶음', '오이느타리버섯볶음', '잔파애느타리버섯볶음', '중국식느타리버섯볶음', '중화풍느타리버섯볶음', '참느타리버섯볶음', '청경채느타리버섯볶음', '친환경느타리버섯볶음', '친환경애호박느타리버섯볶음', '친환경표고느타리버섯볶음', '콩나물느타리버섯볶음', '콩소시지느타리버섯볶음', '파프리카느타리버섯볶음', '피망느타리버섯볶음', '햄느타리버섯볶음', '햄채느타리버섯볶음', '호박고기느타리버섯볶음', '호박느타리버섯볶음', '호박애느타리버섯볶음']
표고버섯볶음밥: ['소고기표고버섯볶음밥']
토란대나물무침: ['토란대나물무침']
취나물된장무침: ['건취나물된장무침', '곰취나물된장무침', '생취나물된장무침', '참취나물된장무침', '취나물된장무침', '친환경취나물된장무침']
시래기나물무침: ['시래기나물무침']
시금치나물무침: ['고추장시금치나물무침', '두부깨시금치나물무침', '시금치나물무침', '친환경시금치나물무침', '표고시금치나물무침']
머위대나물무침: ['머위대나물무침']
도라지나물무침: ['도라지나물무침']
고춧잎나물무침: ['건고춧잎나물무침', '고춧잎나물무침']
고사리나물무침: ['고사리나물무침']
얼갈이배추김치: ['얼갈이배추김치']
무시래기된장국: ['무시래기된장국', '열무시래기된장국']
장어고추장구이: ['바다장어고추장구이', '붕장어고추장구이', '장어고추장구이']
새송이버섯구이: ['가지새송이버섯구이', '계란입힌새송이버섯구이', '고추장새송이버섯구이', '구운마늘과새송이버섯구이', '너비아니새송이버섯구이', '더덕새송이버섯구이', '데리야끼새송이버섯구이', '돈등심새송이버섯구이', '두부새송이버섯구이', '떡갈비새송이버섯구이', '매콤새송이버섯구이', '목살새송이버섯구이', '목삼겹새송이버섯구이', '미니새송이버섯구이', '삼겹살마늘새송이버섯구이', '삼겹새송이버섯구이', '새송이버섯구이', '스틱떡갈비새송이버섯구이', '씨겨자새송이버섯구이', '애호박새송이버섯구이무침', '어린새송이버섯구이', '오리훈제새송이버섯구이', '통마늘새송이버섯구이', '통새송이버섯구이', '허니버터새송이버섯구이', '허브새송이버섯구이', '훈제오리새송이버섯구이']
고등어석쇠구이: ['고등어석쇠구이']
새우젓두부찌개: ['새우젓두부찌개']
양송이버섯볶음: ['감자양송이버섯볶음', '돈육양송이버섯볶음', '버터간장양송이버섯볶음', '버터양송이버섯볶음', '비엔나소시지양송이버섯볶음', '비엔나양송이버섯볶음', '소고기양송이버섯볶음', '쇠고기양송이버섯볶음', '알감자양송이버섯볶음', '양송이버섯볶음', '청경채양송이버섯볶음', '콜리플라워양송이버섯볶음', '표고양송이버섯볶음', '후랑크소시지양송이버섯볶음']
돼지껍데기볶음: ['돼지껍데기볶음']
우거지나물무침: ['우거지나물무침']
냉김치말이국수: ['냉김치말이국수고명']
열무얼갈이김치: ['수제열무얼갈이김치', '열무얼갈이김치', '직접담근열무얼갈이김치', '직접만든열무얼갈이김치']
소고기샤브샤브: ['소고기샤브샤브국', '얼큰소고기샤브샤브국']
햄버그스테이크: ['햄버그스테이크카레덮밥']
후라이드치킨: ['후라이드치킨단짠소스']
간장양념치킨: ['간장양념치킨', '고추간장양념치킨', '꿀간장양념치킨', '마늘간장양념치킨', '베이커드간장양념치킨', '수제간장양념치킨', '순살간장양념치킨', '여우맘간장양념치킨']
해물콩나물찜: ['가마보꼬해물콩나물찜', '꽃게해물콩나물찜', '낙지해물콩나물찜', '단호박해물콩나물찜', '동태해물콩나물찜', '매운해물콩나물찜', '매콤해물콩나물찜', '모둠해물콩나물찜', '모듬해물콩나물찜', '순살아귀해물콩나물찜', '아귀살해물콩나물찜', '아귀해물콩나물찜', '어묵해물콩나물찜', '오징어해물콩나물찜', '주꾸미해물콩나물찜', '해물콩나물찜']
쇠고기사태찜: ['단호박쇠고기사태찜', '쇠고기사태찜']
돼지고기수육: ['돼지고기수육야채무침']
참치김치찌개: ['고추참치김치찌개', '꽁치참치김치찌개', '냉이참치김치찌개', '당면참치김치찌개', '델큐브참치김치찌개', '돈육참치김치찌개', '두부참치김치찌개', '모듬참치김치찌개', '묵은지참치김치찌개', '순두부참치김치찌개', '스팸참치김치찌개', '쑥갓참치김치찌개', '얼큰참치김치찌개', '참치김치찌개', '콩나물참치김치찌개', '퓨전참치김치찌개', '햄참치김치찌개']
조개된장찌개: ['모시조개된장찌개', '바지락조개된장찌개']
어묵김치찌개: ['사각어묵김치찌개', '어묵김치찌개', '참치어묵김치찌개']
버섯샤브샤브: ['버섯샤브샤브탕']
두부된장찌개: ['감자두부된장찌개', '계룡참우렁두부된장찌개', '냉이두부된장찌개', '달래두부된장찌개', '돈육두부된장찌개', '두부된장찌개', '들깨연두부된장찌개', '모듬야채두부된장찌개', '무농약두부된장찌개', '무청두부된장찌개', '미더덕두부된장찌개', '바지락두부된장찌개', '바지락순두부된장찌개', '버섯두부된장찌개', '소고기두부된장찌개', '소고기순두부된장찌개', '쇠고기두부된장찌개', '순두부된장찌개', '애호박두부된장찌개', '얼큰두부된장찌개', '연두부된장찌개', '우렁두부된장찌개', '우렁살두부된장찌개', '전통두부된장찌개', '차돌두부된장찌개', '차돌박이두부된장찌개', '차돌순두부된장찌개', '청량초두부된장찌개', '친환경두부된장찌개', '칼칼한두부된장찌개', '팽이두부된장찌개', '팽이버섯두부된장찌개', '표고두부된장찌개', '한우두부된장찌개', '한우버섯두부된장찌개', '한우차돌두부된장찌개', '해물순두부된장찌개', '호박두부된장찌개']
돼지고기찌개: ['감자돼지고기찌개', '김치돼지고기찌개', '돼지고기찌개', '두부돼지고기찌개', '묵은지돼지고기찌개', '순두부돼지고기찌개', '애호박돼지고기찌개', '얼큰돼지고기찌개', '와촌돼지고기찌개', '콩나물돼지고기찌개']
달래된장찌개: ['냉이달래된장찌개', '달래된장찌개', '두부달래된장찌개', '소고기달래된장찌개', '쇠고기달래된장찌개', '쑥달래된장찌개', '우렁달래된장찌개', '차돌달래된장찌개', '호박달래된장찌개']
냉이된장찌개: ['냉이된장찌개', '달래냉이된장찌개', '바지락냉이된장찌개', '바지락살냉이된장찌개', '조갯살냉이된장찌개']
꽁치김치찌개: ['꽁치김치찌개']
오징어채조림: ['건오징어채조림', '꽈리고추문어맛오징어채조림', '마늘쫑오징어채조림', '문어맛오징어채조림', '반건조버터오징어채조림', '반건조오징어채조림', '버터오징어채조림', '어묵오징어채조림', '오징어채조림', '우엉오징어채조림', '진미오징어채조림']
쇠고기장조림: ['쇠고기장조림밥']
닭고추장조림: ['닭고추장조림', '치즈닭고추장조림']
치커리겉절이: ['치커리겉절이무침']
옥수수샐러드: ['옥수수샐러드볶음', '치즈옥수수샐러드구이']
오징어채무침: ['건무오징어채무침', '건오징어채무침', '고추장오징어채무침', '골뱅이오징어채무침', '깻잎오징어채무침', '꽈리고추오징어채무침', '도라지오징어채무침', '마늘종오징어채무침', '마늘쫑오징어채무침', '마른오징어채무침', '무말랭오징어채무침', '무말랭이오징어채무침', '미나리오징어채무침', '반건조버터오징어채무침', '반건조오징어채무침', '버터오징어채무침', '실오징어채무침', '아몬드오징어채무침', '양배추오징어채무침', '오이오징어채무침', '오징어채무침', '잔파오징어채무침', '진미오징어채무침', '청양마요건오징어채무침', '풋마늘오징어채무침']
오이부추무침: ['깍둑오이부추무침', '꼬막오이부추무침', '노각오이부추무침', '동글오이부추무침', '배오이부추무침', '백오이부추무침', '부여오이부추무침', '생오이부추무침', '오이부추무침', '친환경오이부추무침', '통들깨오이부추무침', '황태오이부추무침']
양파부추무침: ['간장양파부추무침', '겨자양파부추무침', '고깃집양파부추무침', '데리야끼양파부추무침', '매실양파부추무침', '양파부추무침', '오리훈제양파부추무침', '오이양파부추무침', '와사비양파부추무침', '자색양파부추무침', '적양파부추무침']
양상추샐러드: ['양상추샐러드흑임자드레싱']
양배추샐러드: ['양배추샐러드사우전드레싱']
무말랭이무침: ['무말랭이무침담기']
도토리묵무침: ['도토리묵무침참나물']
단호박샐러드: ['단호박샐러드빵']
채소샌드위치: ['감자채소샌드위치', '달걀채소샌드위치', '모듬채소샌드위치', '채소샌드위치']
참치샌드위치: ['참치샌드위치고']
생크림케이크: ['골라먹는생크림케이크', '과일생크림케이크', '눈꽃생크림케이크', '당근생크림케이크', '딸기생크림케이크', '벚꽃생크림케이크', '부드러운생크림케이크', '블루베리생크림케이크', '산타트리생크림케이크', '생크림케이크', '소복생크림케이크', '쇼콜라생크림케이크', '순우유생크림케이크', '스푼생크림케이크', '우리밀딸기생크림케이크', '우리밀생크림케이크', '우유생크림케이크', '입학축하눈꽃생크림케이크', '칼슘생크림케이크', '크리스마스생크림케이크']
참치김치볶음: ['참치김치볶음마요덮밥']
오징어채볶음: ['간장버터오징어채볶음', '건오징어채볶음', '고추장오징어채볶음', '꽈리오징어채볶음', '낙지오징어채볶음', '땅콩버터오징어채볶음', '마늘쫑오징어채볶음', '마른오징어채볶음', '마요오징어채볶음', '매콤오징어채볶음', '무말랭이오징어채볶음', '반건조버터오징어채볶음', '반건조오징어채볶음', '버터오징어채볶음', '실오징어채볶음', '아몬드오징어채볶음', '어묵오징어채볶음', '오징어채볶음', '우엉오징어채볶음', '진미오징어채볶음', '허니버터오징어채볶음']
어묵채소볶음: ['간장어묵채소볶음', '구멍어묵채소볶음', '매콤볼어묵채소볶음', '매콤어묵채소볶음', '모양어묵채소볶음', '볼어묵채소볶음', '봉어묵채소볶음', '부들어묵채소볶음', '비엔나어묵채소볶음', '사각어묵채소볶음', '삼색어묵채소볶음', '소시지어묵채소볶음', '어묵채소볶음', '오색어묵채소볶음', '완자어묵채소볶음', '우엉어묵채소볶음', '잡채어묵채소볶음', '종합어묵채소볶음', '쫀쫀한어묵채소볶음']
브로콜리볶음: ['가지브로콜리볶음', '갈릭갈비살떡갈비브로콜리볶음', '갈비살떡갈비브로콜리볶음', '감자브로콜리볶음', '건새우브로콜리볶음', '게맛살브로콜리볶음', '게살브로콜리볶음밥', '구프랑햄브로콜리볶음', '굴소스베이컨브로콜리볶음', '굴소스브로콜리볶음밥', '그릴소시지브로콜리볶음', '꼬마새송이브로콜리볶음', '꽃맛살브로콜리볶음', '꽃비엔나떡브로콜리볶음', '느타리버섯브로콜리볶음', '느타리브로콜리볶음', '닭가슴살브로콜리볶음', '닭살브로콜리볶음', '당근브로콜리볶음', '대하브로콜리볶음', '돈육브로콜리볶음', '돼지고기브로콜리볶음', '두부브로콜리볶음', '떡갈비브로콜리볶음', '마늘브로콜리볶음', '마늘편브로콜리볶음', '마늘햄브로콜리볶음', '마카로니브로콜리볶음', '맛살브로콜리볶음', '먹물비엔나떡브로콜리볶음', '메추리알브로콜리볶음', '모둠소시지브로콜리볶음', '모듬소세지브로콜리볶음', '모듬햄브로콜리볶음', '모양어묵브로콜리볶음', '무항생제소시지브로콜리볶음', '문어비엔나브로콜리볶음', '미니새송이브로콜리볶음', '미니양배추브로콜리볶음', '미트볼브로콜리볶음', '믹스브로콜리볶음', '방울토마토브로콜리볶음', '버섯브로콜리볶음', '베이컨갈릭브로콜리볶음', '베이컨브로콜리볶음', '베이컨통마늘브로콜리볶음', '볼비엔나브로콜리볶음', '볼어묵브로콜리볶음', '부들어묵브로콜리볶음', '브로콜리볶음', '비엔나떡브로콜리볶음', '비엔나브로콜리볶음', '비엔나소세지브로콜리볶음', '비엔나소시지브로콜리볶음', '비엔나햄브로콜리볶음', '비엔나햄어묵브로콜리볶음', '사각어묵브로콜리볶음', '삼색소시지브로콜리볶음', '새송이버섯브로콜리볶음', '새송이브로콜리볶음', '새송이알브로콜리볶음', '새송이햄브로콜리볶음', '새우갈릭브로콜리볶음', '새우브로콜리볶음', '새우살브로콜리볶음', '소고기브로콜리볶음밥', '소고기햄브로콜리볶음밥', '소세지브로콜리볶음', '소시지브로콜리볶음', '쇠고기브로콜리볶음', '수제소세지브로콜리볶음', '수제소시지브로콜리볶음', '스팸브로콜리볶음', '알감자브로콜리볶음', '알새우브로콜리볶음', '알소시지브로콜리볶음', '애기새송이버섯브로콜리볶음', '애느타리브로콜리볶음', '애호박브로콜리볶음', '양송이브로콜리볶음', '어묵브로콜리볶음', '오리훈제브로콜리볶음', '오징어모양어묵브로콜리볶음', '오징어브로콜리볶음', '올리브새우살브로콜리볶음', '올리브유새우브로콜리볶음', '외계비엔나브로콜리볶음', '우엉어묵브로콜리볶음', '전복브로콜리볶음', '주꾸미목살브로콜리볶음', '주꾸미브로콜리볶음', '죽순브로콜리볶음', '중식브로콜리볶음', '참치브로콜리볶음', '카레감자깍둑브로콜리볶음', '칼집비엔나브로콜리볶음', '콩소시지브로콜리볶음', '콩알새송이브로콜리볶음', '토마토브로콜리볶음', '통그릴비엔나브로콜리볶음', '통마늘브로콜리볶음', '팽이버섯브로콜리볶음', '표고버섯브로콜리볶음', '표고브로콜리볶음', '프랑크브로콜리볶음', '한입떡갈비떡브로콜리볶음', '한입떡갈비브로콜리볶음', '해물브로콜리볶음', '햄감자채브로콜리볶음', '햄브로콜리볶음', '환어묵브로콜리볶음', '후랑크브로콜리볶음', '후랑크소시지브로콜리볶음', '훈제오리브로콜리볶음']
미역줄기볶음: ['미역줄기볶음나물']
감자채소볶음: ['감자채소볶음', '닭감자채소볶음', '베이컨감자채소볶음']
쇠고기주먹밥: ['고추장쇠고기주먹밥', '곤드레쇠고기주먹밥', '구운쇠고기주먹밥', '김가루쇠고기주먹밥', '땡초쇠고기주먹밥', '마늘쇠고기주먹밥', '미니쇠고기주먹밥', '셀프쇠고기주먹밥', '쇠고기주먹밥', '우엉쇠고기주먹밥']
쇠고기볶음밥: ['갈릭쇠고기볶음밥', '건나물쇠고기볶음밥', '고추장쇠고기볶음밥', '곤드레쇠고기볶음밥', '굴소스쇠고기볶음밥', '김가루쇠고기볶음밥', '김치쇠고기볶음밥', '깍두기쇠고기볶음밥', '다진쇠고기볶음밥', '땡초쇠고기볶음밥', '마늘쇠고기볶음밥', '마늘쫑쇠고기볶음밥', '멸치쇠고기볶음밥', '멸치우엉쇠고기볶음밥', '미나리쇠고기볶음밥', '쇠고기볶음밥', '숙주쇠고기볶음밥', '우엉쇠고기볶음밥', '잔멸치쇠고기볶음밥', '청양초쇠고기볶음밥', '파프리카쇠고기볶음밥', '한우쇠고기볶음밥']
돼지머리국밥: ['돼지머리국밥', '얼큰돼지머리국밥']
바지락칼국수: ['바지락칼국수한그릇']
유채나물무침: ['고추장유채나물무침', '사과유채나물무침', '유채나물무침']
오이나물무침: ['숙주오이나물무침', '오이나물무침']
열무나물무침: ['열무나물무침']
숙주나물무침: ['간장무채숙주나물무침', '게맛살숙주나물무침', '국산숙주나물무침', '굴소스숙주나물무침', '김자반숙주나물무침', '느타리숙주나물무침', '단배추숙주나물무침', '단호박숙주나물무침', '당호박숙주나물무침', '두부숙주나물무침', '들깨숙주나물무침', '맛살숙주나물무침', '맛있는숙주나물무침', '매운숙주나물무침', '매콤숙주나물무침', '무농약숙주나물무침', '무장아찌숙주나물무침', '무채숙주나물무침', '미나리숙주나물무침', '미니리숙주나물무침', '베이컨숙주나물무침', '부추숙주나물무침', '브로콜리숙주나물무침', '빨간숙주나물무침', '삼색숙주나물무침', '새우숙주나물무침', '숙주나물무침', '실파숙주나물무침', '쌈배추숙주나물무침', '아삭숙주나물무침', '애호박숙주나물무침', '애호박채숙주나물무침', '얼갈이숙주나물무침', '오이숙주나물무침', '올방개묵숙주나물무침', '유기농숙주나물무침', '유부숙주나물무침', '잔파숙주나물무침', '조개살숙주나물무침', '차돌박이숙주나물무침', '참치숙주나물무침', '청포묵숙주나물무침', '친환경숙주나물무침', '친환경오이숙주나물무침', '크래미숙주나물무침', '크레미숙주나물무침', '파프리카숙주나물무침', '호박숙주나물무침']
비름나물무침: ['담백한비름나물무침', '들기름비름나물무침', '매콤비름나물무침', '비름나물무침', '우렁비름나물무침', '참비름나물무침', '친환경비름나물무침']
배추나물무침: ['단배추나물무침', '배추나물무침', '봄배추나물무침', '속배추나물무침', '속음배추나물무침', '솎음배추나물무침', '알배기배추나물무침', '알배추나물무침', '애배추나물무침', '양배추나물무침', '얼갈이배추나물무침', '청경채단배추나물무침', '청방배추나물무침']
방풍나물무침: ['갯방풍나물무침', '방풍나물무침', '오징어방풍나물무침', '친환경해방풍나물무침', '해방풍나물무침']
냉이나물무침: ['냉이나물무침', '달래냉이나물무침', '봄동냉이나물무침']
깻잎나물무침: ['깻잎나물무침', '두부깻잎나물무침']
건취나물무침: ['건취나물무침']
가지나물무침: ['가지나물무침', '구운가지나물무침', '두가지나물무침', '매콤가지나물무침', '새송이가지나물무침', '찐가지나물무침', '친환경가지나물무침', '허브가지나물무침']
가죽나물무침: ['가죽나물무침']
돌나물물김치: ['돌나물물김치']
고들빼기김치: ['고들빼기김치']
호박잎된장국: ['감자호박잎된장국', '건새우호박잎된장국', '들깨호박잎된장국', '바지락호박잎된장국', '조갯살호박잎된장국', '호박잎된장국']
콩나물된장국: ['곤드레콩나물된장국', '근대콩나물된장국', '김치콩나물된장국', '냉이콩나물된장국', '단배추콩나물된장국', '두부콩나물된장국', '무콩나물된장국', '묵은지콩나물된장국', '미더덕콩나물된장국', '배추콩나물된장국', '북어콩나물된장국', '소고기우거지콩나물된장국', '시금치콩나물된장국', '시래기콩나물된장국', '쑥콩나물된장국', '아욱콩나물된장국', '애배추콩나물된장국', '얼갈이배추콩나물된장국', '얼갈이콩나물된장국', '오징어콩나물된장국', '우거지콩나물된장국', '유부콩나물된장국', '재첩콩나물된장국', '저염시금치콩나물된장국', '조갯살콩나물된장국', '친환경콩나물된장국', '콩나물된장국', '팽이버섯콩나물된장국']
우거지된장국: ['냉이우거지된장국', '달래우거지된장국', '들깨우거지된장국', '들꺠우거지된장?, '등뼈우거지된장국', '매콤우거지된장국', '멸치우거지된장국', '모듬우거지된장국', '무우거지된장국', '미더덕우거지된장국', '배추우거지된장국', '뼈우거지된장국', '사골우거지된장국', '소고기우거지된장국', '소우거지된장국', '쇠고기우거지된장국', '쇠고기콩나물우거지된장국', '시금치우거지된장국', '쑥우거지된장국', '열무우거지된장국', '우거지된장국', '저염우거지된장국', '조갯살우거지된장국', '참치우거지된장국', '청양우거지된장국', '친환경한우우거지된장국', '콩나물우거지된장국', '표고버섯우거지된장국', '한우우거지된장국']
얼갈이배춧국: ['닭고기얼갈이배춧국', '소고기얼갈이배춧국', '쇠고기얼갈이배춧국', '얼갈이배춧국']
애호박된장국: ['감자애호박된장국', '건새우애호박된장국', '꽃게애호박된장국', '냉이애호박된장국', '느타리애호박된장국', '두부애호박된장국', '미더덕애호박된장국', '부여애호박된장국', '새우살애호박된장국', '순두부애호박된장국', '애호박된장국', '어묵애호박된장국', '오만둥이애호박된장국', '재첩두부애호박된장국', '조갯살애호박된장국', '차돌박이애호박된장국', '차돌배기애호박된장국', '친환경애호박된장국', '팽이버섯애호박된장국', '팽이애호박된장국']
시금치된장국: ['시금치된장국한빛']
순두부달걀탕: ['맑은순두부달걀탕', '맛살순두부달걀탕', '몽글순두부달걀탕', '순두부달걀탕', '짬뽕순두부달걀탕']
쇠고기배춧국: ['쇠고기배춧국']
쇠고기미역국: ['쇠고기미역국여']
미역오이냉국: ['레몬미역오이냉국', '물미역오이냉국', '미역오이냉국', '시원미역오이냉국', '친환경미역오이냉국']
김치콩나물국: ['김치콩나물국', '김치콩나물국밥', '냉이김치콩나물국', '돈육김치콩나물국', '두부김치콩나물국', '등뼈김치콩나물국', '로스팜김치콩나물국', '맑은김치콩나물국', '북어김치콩나물국', '소고기김치콩나물국', '쇠고기김치콩나물국', '순두부김치콩나물국', '신김치콩나물국', '어묵김치콩나물국', '얼큰김치콩나물국', '오징어김치콩나물국', '전주식김치콩나물국', '친환경김치콩나물국', '해물김치콩나물국', '황태김치콩나물국']
함박스테이크: ['함박스테이크치즈구이']
표고버섯구이: ['생표고버섯구이', '표고버섯구이']
치킨데리야끼: ['치킨데리야끼소스조림']
오리고기구이: ['대패오리고기구이와', '오리고기구이와']
안심스테이크: ['안심스테이크샐러드']
런천미트구이: ['런천미트구이', '식물성런천미트구이']
등심스테이크: ['등심스테이크볶음']
돼지고기산적: ['돼지고기산적']
돼지갈비구이: ['돼지갈비구이파채무침', '양념돼지갈비구이정식']
한방오리백숙: ['누룽지한방오리백숙', '한방오리백숙']
돼지머리고기: ['돼지머리고기순대국밥']
돼지등갈비찜: ['돼지등갈비찜치즈구이']
소고기버섯죽: ['미니소고기버섯죽', '소고기버섯죽', '전복소고기버섯죽']
포테이토피자: ['포테이토피자토스트']
페퍼로니피자: ['꽃피는페퍼로니피자', '노엣지페퍼로니피자', '또띠아페퍼로니피자', '매운페퍼로니피자', '불고기페퍼로니피자', '수제패스츄리페퍼로니피자', '수제페퍼로니피자', '오뚜기페퍼로니피자', '치아바타페퍼로니피자', '치즈크러스트페퍼로니피자', '페퍼로니피자', '페퍼로니피자토스트', '하와이안페퍼로니피자']
페이스트리빵: ['초코페이스트리빵', '페이스트리빵']
초콜릿케이크: ['초콜릿케이크']
표고버섯볶음: ['감자채표고버섯볶음', '건도토리묵표고버섯볶음', '건표고버섯볶음', '고기표고버섯볶음', '곤드레나물표고버섯볶음', '굴소스표고버섯볶음', '그린빈스표고버섯볶음', '꽈리고추표고버섯볶음', '느타리표고버섯볶음', '돈등심표고버섯볶음', '돈육표고버섯볶음', '돼지고기표고버섯볶음', '두릅생표고버섯볶음', '미역줄기표고버섯볶음', '봄동표고버섯볶음', '부여표고버섯볶음', '브로콜리표고버섯볶음', '비건어묵표고버섯볶음', '새송이표고버섯볶음', '생표고버섯볶음', '쇠고기표고버섯볶음', '숙주표고버섯볶음', '시금치표고버섯볶음', '애느타리표고버섯볶음', '애호박표고버섯볶음', '양배추표고버섯볶음', '어묵표고버섯볶음', '오이표고버섯볶음', '우엉채표고버섯볶음', '죽순표고버섯볶음', '참나물표고버섯볶음', '청경채표고버섯볶음', '취나물표고버섯볶음', '친환경표고버섯볶음', '콩나물표고버섯볶음', '파프리카표고버섯볶음', '표고버섯볶음', '피망표고버섯볶음', '호박표고버섯볶음']
머위나물볶음: ['들깨머위나물볶음', '들깨즙머위나물볶음', '머위나물볶음']
돼지고기볶음: ['돼지고기볶음김치']
깻잎나물볶음: ['깻잎나물볶음']
캘리포니아롤: ['돈까스캘리포니아롤', '미니캘리포니아롤', '수제캘리포니아롤', '캘리포니아롤', '캘리포니아롤주먹밥', '크런치캘리포니아롤']
쑥갓나물무침: ['느타리쑥갓나물무침', '두부쑥갓나물무침', '숙주쑥갓나물무침', '쑥갓나물무침']
달래나물무침: ['달래나물무침']
열무김치국수: ['미니열무김치국수', '열무김치국수']
우거지해장국: ['갈비우거지해장국', '닭고기우거지해장국', '돈등뼈우거지해장국', '돼지우거지해장국', '등뼈우거지해장국', '뼈우거지해장국', '사골우거지해장국', '소고기우거지해장국', '쇠고기우거지해장국', '순대우거지해장국', '우거지해장국', '참치우거지해장국', '한우우거지해장국']
시래기된장국: ['건무청시래기된장국', '건새우시래기된장국', '건시래기된장국', '꽃게시래기된장국', '냉이무청시래기된장국', '냉이시래기된장국', '다슬기시래기된장국', '단배추시래기된장국', '들깨두부시래기된장국', '들깨무청시래기된장국', '들깨시래기된장국', '맑은소고기시래기된장국', '매콤시래기된장국', '무청시래기된장국', '바지락살시래기된장국', '바지락시래기된장국', '방아멸치시래기된장국', '방아시래기된장국', '배추시래기된장국', '사골시래기된장국', '소고기시래기된장국', '쇠고기시래기된장국', '시래기된장국', '얼갈이시래기된장국', '얼큰시래기된장국', '우렁시래기된장국', '재첩시래기된장국', '저염시래기된장국', '조갯살시래기된장국', '죽순시래기된장국', '청량초방아시래기된장국', '친환경시래기된장국', '친환경한우시래기된장국', '콩가루시래기된장국', '콩나물시래기된장국', '통들깨시래기된장국', '통영식시래기된장국', '한우시래기된장국', '홍합시래기된장국']
소고기미역국: ['들깨가루소고기미역국', '들깨소고기미역국', '새알소고기미역국', '소고기미역국', '옹심이소고기미역국', '전복소고기미역국', '찹쌀새알소고기미역국', '한우소고기미역국']
뼈다귀해장국: ['뼈다귀해장국', '통감자뼈다귀해장국']
바지락조개국: ['바지락조개국']
양념장어구이: ['양념장어구이']
오징어튀김: ['오징어튀김꼬지']
소시지튀김: ['뱅글뱅글소시지튀김', '뱅글소시지튀김', '소시지튀김', '쌀소시지튀김', '이탈리안소시지튀김', '콩소시지튀김', '프랑크소시지튀김']
새우탕수육: ['구워먹는새우탕수육', '깐쇼새우탕수육', '두부와새우탕수육', '레몬크림새우탕수육', '만두새우탕수육', '블랙새우탕수육', '새우탕수육', '왕새우탕수육', '찹쌀새우탕수육', '칠리새우탕수육', '콩새우탕수육', '파인애플깐쇼새우탕수육']
등심돈까스: ['등심돈까스피자']
닭날개튀김: ['닭날개튀김조림']
다시마튀각: ['다시마튀각', '미역다시마튀각', '뱅어포다시마튀각', '벵어포다시마튀각']
김말이튀김: ['김말이튀김범벅']
고등어튀김: ['고등어튀김강정']
쇠고기수육: ['쇠고기수육무침']
돼지갈비찜: ['돼지갈비찜덮밥']
꽈리고추찜: ['꽈리고추찜닭']
햄김치찌개: ['돈육모듬햄김치찌개', '돈육햄김치찌개', '모둠햄김치찌개', '모듬햄김치찌개', '부대찌개햄김치찌개', '부대햄김치찌개', '섞어햄김치찌개', '스팸햄김치찌개', '어묵햄김치찌개', '참치햄김치찌개', '캔햄김치찌개', '콩햄김치찌개', '햄김치찌개']
해물매운탕: ['동태해물매운탕', '해물매운탕']
콩비지찌개: ['갈아만든우리콩비지찌개', '검정콩비지찌개', '골뱅이콩비지찌개', '국산돈육콩비지찌개', '국산콩비지찌개', '김치콩비지찌개', '깍두기콩비지찌개', '돈갈비콩비지찌개', '돈등뼈콩비지찌개', '돈사태콩비지찌개', '돈육콩비지찌개', '돈콩비지찌개', '돼지갈비콩비지찌개', '돼지고기듬뿍콩비지찌개', '돼지고기콩비지찌개', '돼지등뼈콩비지찌개', '들기름콩비지찌개', '들깨콩비지찌개', '등갈비콩비지찌개', '등뼈콩비지찌개', '묵은지콩비지찌개', '바지락살콩비지찌개', '바지락콩비지찌개', '생콩비지찌개', '알타리김치콩비지찌개', '얼큰콩비지찌개', '우리콩비지찌개', '청국장콩비지찌개', '총각김치콩비지찌개', '친환경콩비지찌개', '콩비지찌개']
청국장찌개: ['갈비청국장찌개', '구수한청국장찌개', '국산전통청국장찌개', '국산콩청국장찌개', '김치청국장찌개', '깍두기청국장찌개', '냉이청국장찌개', '단호박청국장찌개', '달래청국장찌개', '대패삼겹청국장찌개', '돈육청국장찌개', '돼지고기청국장찌개', '돼지청국장찌개', '두부돈육청국장찌개', '두부청국장찌개', '두부호박청국장찌개', '맑은청국장찌개', '매콤청국장찌개', '멸치청국장찌개', '모시조개청국장찌개', '무농약콩청국장찌개', '무청청국장찌개', '묵은지청국장찌개', '미더덕청국장찌개', '미소청국장찌개', '바지락청국장찌개', '버섯쇠고기청국장찌개', '버섯청국장찌개', '별로냄새안나는청국장찌개', '봄나물청국장찌개', '빡빡한청국장찌개', '석박지청국장찌개', '소고기청국장찌개', '쇠고기달래청국장찌개', '쇠고기청국장찌개', '순두부청국장찌개', '시골청국장찌개', '시래기청국장찌개', '신김치청국장찌개', '야채청국장찌개', '양송이청국장찌개', '어묵청국장찌개', '얼큰청국장찌개', '연두부청국장찌개', '열무청국장찌개', '우렁살청국장찌개', '우렁열무청국장찌개', '우렁청국장찌개', '우리콩우렁청국장찌개', '우리콩전통청국장찌개', '우리콩청국장찌개', '전통우리콩청국장찌개', '전통청국장찌개', '차돌박이청국장찌개', '차돌청국장찌개', '청국장찌개', '총각김치청국장찌개', '콩나물청국장찌개', '토종청국장찌개', '표고청국장찌개', '한우청국장찌개', '해물청국장찌개', '호박청국장찌개']
오징어찌개: ['갑오징어찌개', '꽃게오징어찌개', '느타리오징어찌개', '닭고기오징어찌개', '돌미나리오징어찌개', '두부오징어찌개', '매운오징어찌개', '매콤한오징어찌개', '물오징어찌개', '새송이오징어찌개', '새우오징어찌개', '애호박오징어찌개', '어묵오징어찌개', '얼큰오징어찌개', '오징어찌개', '콩나물오징어찌개', '호박오징어찌개']
순두부찌개: ['순두부찌개한빛']
쇠고기전골: ['김치쇠고기전골', '낙지쇠고기전골', '버섯쇠고기전골', '부여버섯쇠고기전골', '쇠고기전골']
대구매운탕: ['대구매운탕', '맑은대구매운탕', '얼큰대구매운탕', '조개대구매운탕']
양송이스프: ['양송이스프빠네']
코다리조림: ['간장순살코다리조림', '간장코다리조림', '건새우코다리조림', '고구마순코다리조림', '꽈리고추코다리조림', '단호박코다리조림', '달콤간장코다리조림', '대구코다리조림', '데리야끼코다리조림', '매운코다리조림', '매콤달콤코다리조림', '매콤순살코다리조림', '매콤양념순살코다리조림', '매콤양념코다리조림', '매콤코다리조림', '명태알코다리조림', '명태코다리조림', '무코다리조림', '북어코다리조림', '뼈없는코다리조림', '새우코다리조림', '순살코다리조림', '시래기코다리조림', '코다리조림', '콩나물코다리조림', '토막코다리조림']
오징어조림: ['감자오징어조림', '건오징어조림', '구슬오징어조림', '꽈리고추방울오징어조림', '꽈리고추오징어조림', '매콤구슬오징어조림', '매콤오징어조림', '메추리알꽈리오징어조림', '메추리알오징어조림', '물오징어조림', '반건오징어조림', '반건조오징어조림', '방울오징어조림', '솔방울오징어조림', '오징어조림', '우엉건오징어조림', '충무식오징어조림', '충무오징어조림', '콩나물오징어조림']
양미리조림: ['양미리조림']
미트볼조림: ['토마토크린베리미트볼조림']
마늘쫑조림: ['건꼴뚜기마늘쫑조림', '건문어마늘쫑조림', '건새우마늘쫑조림', '고등어마늘쫑조림', '꽁치마늘쫑조림', '나비참쥐포마늘쫑조림', '너비아니마늘쫑조림', '두절새우마늘쫑조림', '마늘쫑조림', '매콤닭마늘쫑조림', '메란마늘쫑조림', '메추리알마늘쫑조림', '멸치마늘쫑조림', '문어마늘쫑조림', '방울오징어마늘쫑조림', '베이컨마늘쫑조림', '북어포마늘쫑조림', '비엔나마늘쫑조림', '새송이마늘쫑조림', '아몬드마늘쫑조림', '어묵마늘쫑조림', '연근마늘쫑조림', '오징어링마늘쫑조림', '오징어칩스마늘쫑조림', '우엉마늘쫑조림', '잔멸치마늘쫑조림', '쥐포마늘쫑조림', '진미마늘쫑조림', '진미채마늘쫑조림', '캐슈넛마늘쫑조림', '한입떡갈비마늘쫑조림', '햄마늘쫑조림']
달걀장조림: ['달걀장조림샐러드덮밥']
고등어조림: ['간고등어조림', '감자시래기고등어조림', '갓김치고등어조림', '강원도곤드레고등어조림', '고구마대고등어조림', '고구마순고등어조림', '고구마줄기고등어조림', '고등어조림', '고사리고등어조림', '김치고등어조림', '꽈리고추고등어조림', '늙은호박고등어조림', '단호박고등어조림', '둥근호박고등어조림', '매실된장고등어조림', '매콤고등어조림', '무고등어조림', '무말랭이고등어조림', '무시래기고등어조림', '무청고등어조림', '묵은지고등어조림', '묵은지자반고등어조림', '불닭소스고등어조림', '뼈없는고등어조림', '순살고등어조림', '시래기고등어조림', '신김치고등어조림', '염고등어조림', '영주간고등어조림', '우거지고등어조림', '자반고등어조림', '중국풍고등어조림']
건갈치조림: ['건갈치조림']
양념새우젓: ['양념새우젓']
양념멸치젓: ['양념멸치젓']
햄달걀부침: ['햄달걀부침전']
해물완자전: ['고추해물완자전', '고칼슘해물완자전', '깻잎해물완자전', '대파해물완자전', '도톰오징어해물완자전', '도톰한해물완자전', '도톰해물완자전', '두부해물완자전', '두툼해물완자전', '바다친구들해물완자전', '버섯해물완자전', '부추해물완자전', '새우해물완자전', '수제해물완자전', '오징어해물완자전', '잡채해물완자전', '칼슘해물완자전', '한입쏘옥해물완자전', '한입쏙해물완자전', '해물완자전']
표고버섯전: ['고기속표고버섯전', '달걀표고버섯전', '표고버섯전']
참치완자전: ['수제참치완자전', '참치완자전']
달걀프라이: ['달걀프라이', '동물복지인증달걀프라이', '무항생제달걀프라이', '수제달걀프라이']
오이장아찌: ['꼬들오이장아찌무침', '무오이장아찌무침', '무채오이장아찌무침']
양파장아찌: ['양파장아찌간장']
마늘장아찌: ['마늘장아찌무침']
더덕장아찌: ['더덕장아찌무침']
깻잎장아찌: ['깻잎장아찌무침']
고추장아찌: ['고추장아찌양념무침']
풋마늘무침: ['갑오징어초풋마늘무침', '갑오징어풋마늘무침', '김가루풋마늘무침', '김풋마늘무침', '북어포풋마늘무침', '브로콜리풋마늘무침', '새콤달콤풋마늘무침', '오징어풋마늘무침', '조갯살풋마늘무침', '파래자반풋마늘무침', '파래풋마늘무침', '풋마늘무침']
채소샐러드: ['채소샐러드핫도그']
참치샐러드: ['참치샐러드밥']
오징어물회: ['갑오징어물회', '골뱅이오징어물회', '데친오징어물회', '오이오징어물회', '오징어물회']
오징어무침: ['오징어무침충무']
오이지무침: ['고추씨기름오이지무침', '꼬들고들오이지무침', '꼬들꼬들오이지무침', '꼬들꼬들한오이지무침', '꼬들단무지오이지무침', '꼬들매실오이지무침', '꼬들무채오이지무침', '꼬들오이지무침', '꼬들한오이지무침', '나트륨감소된오이지무침', '단무지오이지무침', '달콤오이지무침', '들기름오이지무침', '레몬오이지무침', '마늘쫑오이지무침', '맑은오이지무침', '매실고추오이지무침', '매실꼬들오이지무침', '매실오이지무침', '매실장아찌오이지무침', '매실절임오이지무침', '매운오이지무침', '매콤오이지무침', '무농약오이지무침', '무채오이지무침', '배오이지무침', '부추오이지무침', '삭힌고추오이지무침', '새콤오이지무침', '아삭오이지무침', '아삭한오이지무침', '오복지오이지무침', '오이지무침', '유자청오이지무침', '저나트륨오이지무침', '저염오이지무침', '절임오이지무침', '죽순오이지무침', '즉석오이지무침', '짜지않은오이지무침', '쪼글오이지무침', '쫄깃오이지무침', '쫄깃한오이지무침', '참나물오이지무침', '하얀오이지무침']
열무겉절이: ['단배추열무겉절이', '배추열무겉절이', '선열무겉절이', '솎음열무겉절이', '알배기배추와열무겉절이', '어린열무겉절이', '얼갈이배추열무겉절이', '얼갈이열무겉절이', '열무겉절이', '오이열무겉절이', '유자청열무겉절이', '제피열무겉절이', '토마토된장열무겉절이', '토마토열무겉절이']
상추겉절이: ['상추겉절이나물']
북어채무침: ['골뱅이북어채무침', '도라지북어채무침', '무말랭이북어채무침', '북어채무침', '오이북어채무침']
배추겉절이: ['배추겉절이담그기']
미역초무침: ['건미역초무침여', '꽃맛살미역초무침']
미나리무침: ['숙주미나리무침여고']
마늘쫑무침: ['간장마늘쫑무침', '건새우마늘쫑무침', '고추장마늘쫑무침', '꽈리고추마늘쫑무침', '더덕마늘쫑무침', '도라지마늘쫑무침', '락교마늘쫑무침', '마늘쫑무침', '맛살마늘쫑무침', '매실간장마늘쫑무침', '매콤마늘쫑무침', '멸치마늘쫑무침', '백진미채마늘쫑무침', '북어포마늘쫑무침', '빨간마늘쫑무침', '새송이마늘쫑무침', '새콤마늘쫑무침', '생마늘쫑무침', '숙성마늘쫑무침', '아삭마늘쫑무침', '알마늘지마늘쫑무침', '어묵마늘쫑무침', '오이지마늘쫑무침', '오징어마늘쫑무침', '오징어채마늘쫑무침', '유자무채마늘쫑무침', '일미마늘쫑무침', '잔멸치마늘쫑무침', '지리멸치마늘쫑무침', '진미마늘쫑무침', '진미채마늘쫑무침', '쭈꾸미마늘쫑무침', '통마늘마늘쫑무침', '햄마늘쫑무침', '햇마늘쫑무침']
돌나물무침: ['갑오징어돌나물무침', '곤약돌나물무침', '골뱅이돌나물무침', '달래돌나물무침', '도라지돌나물무침', '도토리묵돌나물무침', '돌나물무침', '들깨돌나물무침', '무돌나물무침', '배돌나물무침', '부추돌나물무침', '사과돌나물무침', '상추돌나물무침', '새콤돌나물무침', '세발돌나물무침', '소라골뱅이돌나물무침', '수삼돌나물무침', '양파돌나물무침', '오이돌나물무침', '오징어돌나물무침', '오징어링돌나물무침', '유자청돌나물무침', '주꾸미돌나물무침', '청포묵돌나물무침', '친환경돌나물무침', '콜라비돌나물무침', '파인애플돌나물무침', '파채돌나물무침']
도라지생채: ['도라지생채무침', '오이도라지생채나물', '진미도라지생채나물']
닭고기냉채: ['닭고기냉채', '새콤달콤닭고기냉채']
다시마무침: ['생다시마무침젓갈']
과일샐러드: ['과일샐러드키위드레싱']
감자샐러드: ['감자샐러드스테이크']
햄샌드위치: ['감자햄샌드위치', '달걀햄샌드위치', '달콤치즈햄샌드위치', '달콤햄샌드위치', '모닝빵햄샌드위치', '모짜렐라치즈햄샌드위치', '불고기햄샌드위치', '사과햄샌드위치', '상추햄샌드위치', '양상치햄샌드위치', '에그햄샌드위치', '잠봉뵈르햄샌드위치', '치즈햄샌드위치', '콘치즈햄샌드위치', '크루아상햄샌드위치', '크림치즈햄샌드위치', '포테이토햄샌드위치', '햄샌드위치']
페이스트리: ['페이스트리핫도그']
초코소라빵: ['미각초코소라빵', '초코소라빵']
식빵토스트: ['달걀식빵토스트', '달걀품은식빵토스트', '마늘식빵토스트', '무지개식빵토스트', '베이컨식빵토스트', '블루베리식빵토스트', '생크림식빵토스트', '센치한식빵토스트', '수제식빵토스트', '식빵토스트', '우리학교식빵토스트', '카야잼식빵토스트', '크림치즈식빵토스트', '프렌치식빵토스트']
불고기버거: ['불고기버거소스']
감자크로켓: ['감자크로켓과']
햄채소볶음: ['감자햄채소볶음', '굴소스햄채소볶음밥', '런천햄채소볶음', '모둠햄채소볶음', '모듬햄채소볶음', '베이컨햄채소볶음밥', '비엔나햄채소볶음', '새우살햄채소볶음밥', '스모크햄채소볶음', '쵸핑햄채소볶음밥', '카레햄채소볶음밥', '햄채소볶음']
콩나물잡채: ['굴소스콩나물잡채', '김치콩나물잡채', '납작당면콩나물잡채', '느타리버섯콩나물잡채', '당면콩나물잡채', '두절콩나물잡채', '매운콩나물잡채', '매콤콩나물잡채', '묵은지콩나물잡채', '부추콩나물잡채', '빨간콩나물잡채', '새콤달콤콩나물잡채', '쇠고기콩나물잡채', '아삭콩나물잡채', '어묵콩나물잡채', '얼큰콩나물잡채', '오색콩나물잡채', '우엉콩나물잡채', '유부콩나물잡채', '전라도식콩나물잡채', '중국콩나물잡채', '친환경콩나물잡채', '콩나물잡채', '콩나물잡채밥', '파프리카콩나물잡채', '햄콩나물잡채']
채소떡볶이: ['달걀채소떡볶이', '매운채소떡볶이', '소세지채소떡볶이', '어묵채소떡볶이', '채소떡볶이']
잔멸치볶음: ['가마보꼬잔멸치볶음', '간장잔멸치볶음', '감말랭이잔멸치볶음', '감자잔멸치볶음', '건과일잔멸치볶음', '건파래잔멸치볶음', '검정콩찹쌀튀각잔멸치볶음', '견과류잔멸치볶음', '견과잔멸치볶음', '고구마줄기잔멸치볶음', '고래밥떡잔멸치볶음', '고추잔멸치볶음', '고추장잔멸치볶음', '깨순잔멸치볶음', '꽈리고추잔멸치볶음', '꽈리잔멸치볶음', '누룽지잔멸치볶음', '땅콩바삭잔멸치볶음', '땅콩잔멸치볶음', '땡초잔멸치볶음밥', '마늘종잔멸치볶음', '매콤잔멸치볶음', '모듬견과류잔멸치볶음', '모듬견과잔멸치볶음', '모듬햄잔멸치볶음', '뮤즐리잔멸치볶음', '병아리콩잔멸치볶음', '비엔나아몬드잔멸치볶음', '비엔나잔멸치볶음', '뿌리채소잔멸치볶음밥', '사각햄잔멸치볶음', '생땅콩잔멸치볶음', '소시지잔멸치볶음', '쇠고기잔멸치볶음밥', '시리얼잔멸치볶음', '아몬드잔멸치볶음', '얼큰잔멸치볶음밥', '연근잔멸치볶음', '우엉잔멸치볶음밥', '유자청잔멸치볶음', '자반잔멸치볶음밥', '잔멸치볶음', '잔멸치볶음주먹밥', '참나물잔멸치볶음밥', '찹쌀콩견과류잔멸치볶음', '찹쌀콩잔멸치볶음', '청량고추잔멸치볶음', '청양잔멸치볶음', '칼슘가득잔멸치볶음', '캐슈넛잔멸치볶음', '콩부각잔멸치볶음', '콩줄기잔멸치볶음', '콩찹쌀튀각잔멸치볶음', '콩튀각잔멸치볶음', '크랜베리견과류잔멸치볶음', '크랜베리아몬드잔멸치볶음', '크랜베리잔멸치볶음', '크린베리잔멸치볶음', '통곡물뮤즐리잔멸치볶음', '통곡물잔멸치볶음', '통아몬드잔멸치볶음', '파래자반잔멸치볶음', '파프리카잔멸치볶음', '편마늘잔멸치볶음', '풋고추잔멸치볶음', '하루견과잔멸치볶음', '하트뮤즐리잔멸치볶음', '해씨잔멸치볶음', '현미시리얼잔멸치볶음', '호두살잔멸치볶음', '호두쏙쏙잔멸치볶음', '호두잔멸치볶음', '호두칼슘잔멸치볶음', '호박씨잔멸치볶음', '혼합견과류잔멸치볶음', '혼합잔멸치볶음', '후리가케잔멸치볶음밥']
오징어볶음: ['오징어볶음치즈덮밥']
쇠고기볶음: ['쇠고기볶음장김주먹밥']
소시지볶음: ['중화풍소시지볶음면']
마늘쫑볶음: ['꽃새우마늘쫑볶음', '마늘쫑볶음면', '소고기마늘쫑볶음면', '쇠고기마늘쫑볶음면']
건새우볶음: ['가지건새우볶음', '건새우볶음', '건조묵마늘쫑건새우볶음', '견과류건새우볶음', '고구마순건새우볶음', '고구마줄기건새우볶음', '고추장건새우볶음', '꽈리건새우볶음', '꽈리고추건새우볶음', '꽈리초건새우볶음', '너트건새우볶음', '두절건새우볶음', '마늘잎건새우볶음', '마늘종건새우볶음', '마늘쫑건새우볶음', '매콤건새우볶음', '매콤마늘쫑건새우볶음', '멸치건새우볶음', '무말랭이건새우볶음', '뱅어포건새우볶음', '버섯건새우볶음', '브로컬리건새우볶음', '브로콜리건새우볶음', '비건새우볶음', '아몬드건새우볶음', '아몬드멸치건새우볶음', '애호박건새우볶음', '양배추건새우볶음', '오징어건새우볶음', '진미건새우볶음', '쪽파건새우볶음', '청경채건새우볶음', '친환경호박건새우볶음', '콩줄기건새우볶음', '파프리카건새우볶음', '햄건새우볶음', '호두건새우볶음', '호두연근멸치건새우볶음', '호박건새우볶음', '호박고지건새우볶음']
하이라이스: ['하이라이스새우덮밥']
콩나물국밥: ['전주콩나물국밥한그릇']
카레라이스: ['카레라이스피자']
채소볶음밥: ['게맛살채소볶음밥', '게살채소볶음밥', '계란채소볶음밥', '굴소스달걀채소볶음밥', '굴소스채소볶음밥', '김가루채소볶음밥', '김채소볶음밥', '김치채소볶음밥', '낙지채소볶음밥', '날치알채소볶음밥', '달걀채소볶음밥', '닭갈비채소볶음밥', '대게살채소볶음밥', '돈육채소볶음밥', '돼지고기채소볶음밥', '떡갈비채소볶음밥', '맛살채소볶음밥', '매콤고기채소볶음밥', '멸치채소볶음밥', '모듬채소볶음밥', '목살채소볶음밥', '미나리채소볶음밥', '미니채소볶음밥', '버섯채소볶음밥', '베이컨김치채소볶음밥', '베이컨채소볶음밥', '불고기채소볶음밥', '뿌리채소볶음밥', '삼겹살채소볶음밥', '새우살채소볶음밥', '새우채소볶음밥', '섭산적채소볶음밥', '소고기야채소볶음밥', '소고기우엉채소볶음밥', '소고기채소볶음밥', '소시지채소볶음밥', '쇠고기계란채소볶음밥', '쇠고기우엉채소볶음밥', '쇠고기채소볶음밥', '스크램블채소볶음밥', '스팸채소볶음밥', '씻은김치채소볶음밥', '안심채소볶음밥', '연어채소볶음밥', '오리고기채소볶음밥', '오리채소볶음밥', '오리훈제채소볶음밥', '오색채소볶음밥', '오징어채소볶음밥', '우엉채소볶음밥', '유부채소볶음밥', '적은스팸채소볶음밥', '주꾸미채소볶음밥', '직화오징어채소볶음밥', '차돌박이채소볶음밥', '참치채소볶음밥', '채소볶음밥', '철판달걀채소볶음밥', '카레채소볶음밥', '콩고기채소볶음밥', '크래미채소볶음밥', '토마토카레채소볶음밥', '통소시지채소볶음밥', '한돈채소볶음밥', '한우모듬채소볶음밥', '한우채소볶음밥', '햄채소볶음밥', '홍채소볶음밥', '후랑크채소볶음밥', '후리가케채소볶음밥', '훈제오리채소볶음밥']
참치볶음밥: ['간장달걀참치볶음밥', '고추장참치볶음밥', '고추참치볶음밥', '김가루참치볶음밥', '김치참치볶음밥', '깍두기참치볶음밥', '날치알참치볶음밥', '매운참치볶음밥', '매콤참치볶음밥', '미니참치볶음밥', '불참치볶음밥', '빨간참치볶음밥', '스팸김치참치볶음밥', '야채참치볶음밥', '참치볶음밥', '철판참치볶음밥', '치즈김치참치볶음밥', '후리가케햄참치볶음밥', '후리카케참치볶음밥']
육회비빔밥: ['육회비빔밥']
오징어덮밥: ['오징어덮밥소스']
오므라이스: ['오므라이스컵밥']
쇠고기김밥: ['매운쇠고기김밥', '매콤쇠고기김밥볶음밥', '쇠고기김밥']
쇠머리국밥: ['쇠머리국밥']
새우볶음밥: ['간단새우볶음밥', '갈릭버터새우볶음밥', '갈릭새우볶음밥', '강황라이스새우볶음밥', '건밥새우볶음밥', '건새우볶음밥', '게맛살새우볶음밥', '게살새우볶음밥', '게장새우볶음밥', '계란부추새우볶음밥', '계란새우볶음밥', '굴소스새우볶음밥', '그린빈새우볶음밥', '김치새우볶음밥', '깐쇼새우볶음밥', '꼬들탱글통새우볶음밥', '나시고랭마늘쫑새우볶음밥', '나시고랭새우볶음밥', '나시고렝새우볶음밥', '날치알새우볶음밥', '노란새우볶음밥', '달걀새우볶음밥', '닭고기새우볶음밥', '닭살새우볶음밥', '대게살새우볶음밥', '대게새우볶음밥', '데리야끼마늘쫑새우볶음밥', '돈까스속새우볶음밥', '떡갈비김치새우볶음밥', '마늘새우볶음밥', '마늘종새우볶음밥', '마늘쫑새우볶음밥', '마늘쫑장아찌새우볶음밥', '마늘편새우볶음밥', '매콤날치알새우볶음밥', '매콤새우볶음밥', '멕시칸새우볶음밥', '멸치새우볶음밥', '목살새우볶음밥', '무항생제오리새우볶음밥', '미니새우볶음밥', '미니야채새우볶음밥', '밥새우볶음밥', '버섯새우볶음밥', '버터갈릭새우볶음밥', '버터플라이새우볶음밥', '베이컨김치새우볶음밥', '베이컨새우볶음밥', '베트남새우볶음밥', '부추달걀새우볶음밥', '부추새우볶음밥', '불닭새우볶음밥', '브로컬리새우볶음밥', '브로콜리베이컨새우볶음밥', '브로콜리새우볶음밥', '비건파인애플새우볶음밥', '빠야새우볶음밥', '사천새우볶음밥', '사천식새우볶음밥', '새우볶음밥', '쇠고기새우볶음밥', '스리라차새우볶음밥', '스크램블계란새우볶음밥', '스크램블새우볶음밥', '스팸마늘쫑새우볶음밥', '씻은김치새우볶음밥', '아보카도새우볶음밥', '알새우볶음밥', '야채새우볶음밥', '양송이새우볶음밥', '연근새우볶음밥', '오리새우볶음밥', '오리훈제새우볶음밥', '오징어새우볶음밥', '울진붉은대게살새우볶음밥', '잠발라야새우볶음밥', '전복새우볶음밥', '주꾸미새우볶음밥', '중국식마늘새우볶음밥', '중국식새우볶음밥', '중국식숙주새우볶음밥', '중화새우볶음밥', '중화식새우볶음밥', '중화풍새우볶음밥', '짜장달걀새우볶음밥', '철판새우볶음밥', '치즈새우볶음밥', '친환경새우볶음밥', '친환경쌀새우볶음밥', '칠리새우볶음밥', '칠리소스새우볶음밥', '카레새우볶음밥', '컵새우볶음밥', '코코넛새우볶음밥', '크래미새우볶음밥', '크레비아새우볶음밥', '큰새우볶음밥', '킹새우볶음밥', '킹타이거새우볶음밥', '통새우볶음밥', '튼튼새우볶음밥', '파기름새우볶음밥', '파인새우볶음밥', '파인애플새우볶음밥', '파프리카새우볶음밥', '하노이새우볶음밥', '하와이안새우볶음밥', '한우새우볶음밥', '햄새우볶음밥', '후리가케새우볶음밥', '후리카케새우볶음밥', '훈제오리새우볶음밥', '흑미새우볶음밥']
불고기덮밥: ['낙지불고기덮밥소스', '돈불고기덮밥소스', '매콤불고기덮밥소스', '불고기덮밥소스', '오징어불고기덮밥소스', '우불고기덮밥소스', '제육불고기덮밥소스', '한우불고기덮밥소스']
돌솥비빔밥: ['돌솥비빔밥', '치즈김치돌솥비빔밥']
돈까스김밥: ['깻잎돈까스김밥', '돈까스김밥', '모계돈까스김밥', '비건돈까스김밥', '수제돈까스김밥', '의성고돈까스김밥', '이서돈까스김밥', '접어먹는흑돼지돈까스김밥']
닭고기덮밥: ['닭고기덮밥소스']
날치알김밥: ['날치알김밥']
김치볶음밥: ['김치볶음밥과블랙퍼스트소시지', '김치볶음밥피자']
계란볶음밥: ['간장계란볶음밥', '게맛살계란볶음밥', '게살계란볶음밥', '계란볶음밥', '굴소스계란볶음밥', '굴소스새우계란볶음밥', '김가루계란볶음밥', '김치계란볶음밥', '김치햄계란볶음밥', '깍두기계란볶음밥', '닭가슴살계란볶음밥', '닭날개계란볶음밥', '대게살계란볶음밥', '대파계란볶음밥', '등촌계란볶음밥', '등촌식계란볶음밥', '마늘계란볶음밥', '마늘쫑계란볶음밥', '맛살계란볶음밥', '멸치계란볶음밥', '미나리계란볶음밥', '미니계란볶음밥', '미니대파계란볶음밥', '미정계란볶음밥', '버섯계란볶음밥', '버터간장계란볶음밥', '버터계란볶음밥', '버터장조림계란볶음밥', '베이컨계란볶음밥', '베이컨야채계란볶음밥', '베이컨햄계란볶음밥', '베트남식계란볶음밥', '볶음김치와대파계란볶음밥', '부추계란볶음밥', '불고기계란볶음밥', '비엔나계란볶음밥', '새우계란볶음밥', '새우굴소스계란볶음밥', '새우살계란볶음밥', '새우살굴소스계란볶음밥', '새우야채계란볶음밥', '소고기계란볶음밥', '소세지계란볶음밥', '소시지계란볶음밥', '쇠고기계란볶음밥', '스크램블계란볶음밥', '스팸계란볶음밥', '시금치계란볶음밥', '야채계란볶음밥', '양송이계란볶음밥', '오리계란볶음밥', '오이계란볶음밥', '오징어계란볶음밥', '우엉멸치계란볶음밥', '장조림계란볶음밥', '장조림버터계란볶음밥', '전복계란볶음밥', '중국식계란볶음밥', '중식계란볶음밥', '중화식계란볶음밥', '중화식새우계란볶음밥', '중화풍계란볶음밥', '짜장계란볶음밥', '참치간장계란볶음밥', '참치계란볶음밥', '치킨계란볶음밥', '친환경계란볶음밥', '칵테일새우계란볶음밥', '크래미계란볶음밥', '크리미계란볶음밥', '통새우살계란볶음밥', '파계란볶음밥', '파기름계란볶음밥', '파인애플계란볶음밥', '파채계란볶음밥', '해물계란볶음밥', '햄간장계란볶음밥', '햄계란볶음밥', '햄구이계란볶음밥', '햄김치계란볶음밥', '햄야채계란볶음밥', '햄채소계란볶음밥', '후랑크계란볶음밥', '후리가케계란볶음밥', '흑미계란볶음밥', '흰계란볶음밥']
사골만두국: ['꼬물이사골만두국', '떡사골만두국', '사골만두국', '한우사골만두국']
톳나물무침: ['두부톳나물무침', '무톳나물무침', '생톳나물무침', '콩나물톳나물무침', '톳나물무침']
콩나물무침: ['콩나물무침고']
참나물무침: ['갑오징어참나물무침', '검은깨올방개묵참나물무침', '고구마참나물무침', '고소참나물무침', '고소한참나물무침', '고추장참나물무침', '골뱅이참나물무침', '골뱅참나물무침', '공주밤묵참나물무침', '구운두부참나물무침', '국산도토리묵참나물무침', '김가루참나물무침', '김참나물무침', '깨찰묵참나물무침', '깻잎참나물무침', '꼬막살참나물무침', '꼬막참나물무침', '낙지참나물무침', '녹두묵참나물무침', '느타리버섯참나물무침', '느타리참나물무침', '단감참나물무침', '단무지참나물무침', '달래참나물무침', '더덕참나물무침', '도라지참나물무침', '도토리묵참나물무침', '도토리참나물무침', '된장참나물무침', '두부가라아게참나물무침', '두부참나물무침', '들기름참나물무침', '들깨가루참나물무침', '들깨참나물무침', '들깨해초국수참나물무침', '땅콩참나물무침', '무말랭이미나리참나물무침', '무말랭이참나물무침', '무참나물무침', '물미역참나물무침', '방풍참나물무침', '배참나물무침', '백년초묵참나물무침', '부여양배추참나물무침', '부추참나물무침', '사과참나물무침', '삼색묵참나물무침', '상추참나물무침', '상큼참나물무침', '새송이참나물무침', '새콤달콤참나물무침', '새콤참나물무침', '생참나물무침', '소고기참나물무침', '쇠고기참나물무침', '숙주참나물무침', '시금치참나물무침', '실곤약참나물무침', '양배추참나물무침', '양파참나물무침', '얼갈이참나물무침', '얼큰참나물무침', '영양부추참나물무침', '오리엔탈참나물무침', '오리훈제참나물무침', '오이참나물무침', '오징어참나물무침', '올방개묵참나물무침', '올방개참나물무침', '우렁이참나물무침', '유자청사과참나물무침', '유자청참나물무침', '으깬두부참나물무침', '잣가루참나물무침', '주꾸미참나물무침', '차돌박이참나물무침', '참깨참나물무침', '참나물무침', '청경채참나물무침', '청포묵참나물무침', '치자묵참나물무침', '친환경숙주참나물무침', '친환경참나물무침', '콩나물참나물무침', '토마토참나물무침', '파래참나물무침', '파채참나물무침', '파프리카참나물무침', '팽이버섯참나물무침', '팽이참나물무침', '한치참나물무침', '해물참나물무침', '향긋한참나물무침', '호두가루참나물무침', '호두참나물무침', '홍고추참나물무침', '흑임자참나물무침']
애호박볶음: ['애호박볶음나물']
무나물무침: ['들기름무나물무침', '들깨무나물무침', '무나물무침', '오징어무나물무침', '콩나물무나물무침']
오이소박이: ['오이소박이담기']
해물된장국: ['꽃게해물된장국', '모듬해물된장국', '미더덕해물된장국', '반지락해물된장국', '얼큰해물된장국', '연두부해물된장국', '열무해물된장국', '오징어해물된장국', '콩나물해물된장국', '해물된장국']
우거지곰탕: ['한우사골우거지곰탕']
아욱된장국: ['감자아욱된장국', '건보리새우아욱된장국', '건새우아욱된장국', '꼬막살아욱된장국', '꽃새우아욱된장국', '다슬기아욱된장국', '두절건새우아욱된장국', '들깨아욱된장국', '민물새우아욱된장국', '바지락살아욱된장국', '바지락아욱된장국', '보리새우아욱된장국', '부여아욱된장국', '새우살아욱된장국', '새우아욱된장국', '생새우살아욱된장국', '생새우아욱된장국', '수제비아욱된장국', '시금치아욱된장국', '아욱된장국', '올갱이아욱된장국', '우렁살아욱된장국', '우렁아욱된장국', '우렁이아욱된장국', '유부아욱된장국', '이아욱된장국', '재첩아욱된장국', '조개살아욱된장국', '조갯살아욱된장국', '조랭이아욱된장국', '쭈꾸미아욱된장국', '친환경아욱된장국', '콩가루아욱된장국', '콩나물아욱된장국', '팽이버섯아욱된장국', '팽이아욱된장국', '표고버섯아욱된장국']
쇠고기무국: ['가마솥쇠고기무국', '경남식쇠고기무국', '경상도쇠고기무국', '경상도식쇠고기무국', '느타리쇠고기무국', '당면쇠고기무국', '듬뿍쇠고기무국', '맑은쇠고기무국', '매운쇠고기무국', '매콤쇠고기무국', '매콤한쇠고기무국', '빨간쇠고기무국', '새송이쇠고기무국', '서울식쇠고기무국', '쇠고기무국', '숙주쇠고기무국', '식쇠고기무국', '안동식쇠고기무국', '알배기쇠고기무국', '얼큰쇠고기무국', '얼큰한경상도식쇠고기무국', '얼큰한쇠고기무국', '얼큰한우쇠고기무국', '얼튼쇠고기무국', '온천골쇠고기무국', '우거지쇠고기무국', '장터쇠고기무국', '파송송쇠고기무국', '팽이버섯쇠고기무국', '한방쇠고기무국', '한우쇠고기무국']
새우미역국: ['건새우미역국', '깐새우미역국', '대합새우미역국', '두절새우미역국', '들깨새우미역국', '보리새우미역국', '새우미역국', '생새우미역국', '소고기새우미역국', '쇠고기새우미역국', '전복새우미역국']
배추된장국: ['가을배추된장국', '감자배추된장국', '건새우단배추된장국', '건새우배추된장국', '건새우얼갈이배추된장국', '고추단배추된장국', '국배추된장국', '굴배추된장국', '굴통배추된장국', '근대배추된장국', '꼬막배추된장국', '꼬막살애배추된장국', '낙지배추된장국', '냉이단배추된장국', '냉이배추된장국', '냉이애배추된장국', '다슬기단배추된장국', '다슬기배추된장국', '단배추된장국', '닭배추된장국', '대합살배추된장국', '돼지고기배추된장국', '두부배추된장국', '두부알배추된장국', '들깨가루배추된장국', '들깨감자배추된장국', '들깨단배추된장국', '들깨배추된장국', '들깨얼갈이배추된장국', '땡초단배추된장국', '맑은단배추된장국', '매콤들깨단배추된장국', '무청단배추된장국', '미더덕배추된장국', '바지락배추된장국', '바지락살단배추된장국', '바지락살배추된장국', '배추된장국', '버섯알배추된장국', '봄동배추된장국', '사골배추된장국', '새우살배추된장국', '생배추된장국', '생콩가루배추된장국', '생표고얼갈이배추된장국', '소고기배추된장국', '소고기얼갈이배추된장국', '속배추된장국', '속음배추된장국', '솎음배추된장국', '쇠고기단배추된장국', '쇠고기배추된장국', '쇠고기애배추된장국', '쇠고기콩나물배추된장국', '쌈배추된장국', '쑥단배추된장국', '쑥배추된장국', '알배기배추된장국', '알배추된장국', '애기배추된장국', '애배추된장국', '애호박배추된장국', '양배추된장국', '양송이배추된장국', '어린배추된장국', '얼가리배추된장국', '얼갈이배추된장국', '얼배추된장국', '얼큰배추된장국', '얼큰소고기배추된장국', '여리배추된장국', '연배추된장국', '열무배추된장국', '우렁배추된장국', '우렁살단배추된장국', '우렁살배추된장국', '우렁얼갈이배추된장국', '유부배추된장국', '조개살단배추된장국', '조개살배추된장국', '조갯살단배추된장국', '조갯살배추된장국', '조갯살애배추된장국', '조갯살통배추된장국', '차돌배추된장국', '청방배추된장국', '청양고추단배추된장국', '콩가루단배추된장국', '콩가루배추된장국', '콩가루속배추된장국', '콩가루애배추된장국', '콩가루얼갈이배추된장국', '콩가루조갯살배추된장국', '콩가배추된장국', '콩나물배추된장국', '콩나물얼갈이배추된장국', '통배추된장국', '팽이배추된장국', '팽이버섯배추된장국', '풋고추단배추된장국', '풋배추된장국', '한우배추된장국', '한우얼갈이배추된장국', '호배추된장국']
미역된장국: ['감자미역된장국', '건미역된장국', '건새우미역된장국', '두부미역된장국', '떡미역된장국', '무채미역된장국', '미소두부미역된장국', '미소미역된장국', '미역된장국', '순두부미역된장국', '유부미역된장국', '일본식미역된장국', '일식미역된장국', '참치미역된장국', '콩나물미역된장국', '팽이두부미역된장국', '팽이미역된장국', '팽이버섯미역된장국']
대합미역국: ['대합미역국', '들깨대합미역국', '새송이대합미역국', '새알대합미역국', '새우살대합미역국', '소고기대합미역국', '쇠고기대합미역국', '전복대합미역국', '찹쌀경단대합미역국', '한우대합미역국', '황태대합미역국']
냉이된장국: ['감자냉이된장국', '건새우냉이된장국', '곰밤부리냉이된장국', '굴냉이된장국', '근대냉이된장국', '김치냉이된장국', '꼬막냉이된장국', '꽃게냉이된장국', '냉이된장국', '단배추냉이된장국', '달래냉이된장국', '대합살냉이된장국', '두부냉이된장국', '바지락냉이된장국', '바지락봄동냉이된장국', '바지락살냉이된장국', '배추냉이된장국', '보리냉이된장국', '보리순냉이된장국', '봄동냉이된장국', '섬초냉이된장국', '쇠고기냉이된장국', '시금치냉이된장국', '시래기냉이된장국', '쑥냉이된장국', '애배추냉이된장국', '애호박냉이된장국', '얼갈이냉이된장국', '오만둥이냉이된장국', '올갱이냉이된장국', '우렁두부냉이된장국', '우렁이냉이된장국', '재첩시금치냉이된장국', '조개냉이된장국', '조개살냉이된장국', '조개쑥냉이된장국', '조갯살냉이된장국', '쭈꾸미냉이된장국', '친환경냉이된장국', '콩가루냉이된장국', '콩가루조갯살냉이된장국', '콩나물냉이된장국']
근대된장국: ['감근대된장국', '감자근대된장국', '건새우근대된장국', '구수한근대된장국', '굴근대된장국', '근대된장국', '냉이근대된장국', '다슬기근대된장국', '단호박근대된장국', '돈육근대된장국', '두부근대된장국', '들깨근대된장국', '맑은근대된장국', '민물새우근대된장국', '바지락근대된장국', '바지락살근대된장국', '버섯근대된장국', '보리새우근대된장국', '부여근대된장국', '새우살근대된장국', '생새우살근대된장국', '소고기근대된장국', '쇠고기근대된장국', '수제비근대된장국', '시금치근대된장국', '실치근대된장국', '아욱근대된장국', '얼큰근대된장국', '연두부근대된장국', '올갱이근대된장국', '우렁근대된장국', '우렁살근대된장국', '유부근대된장국', '적근대된장국', '조갯살근대된장국', '친환경근대된장국', '콩가루근대된장국', '콩나물근대된장국', '팽이근대된장국', '팽이버섯근대된장국', '표고근대된장국', '호박근대된장국', '황태근대된장국']
감자된장국: ['감자된장국', '건새우감자된장국', '건새우아욱감자된장국', '근대감자된장국', '깻잎감자된장국', '꽃게감자된장국', '냉이감자된장국', '다슬기감자된장국', '달래감자된장국', '두부감자된장국', '마늘쫑감자된장국', '마디호박감자된장국', '매콤감자된장국', '무시래기감자된장국', '무청시래기감자된장국', '미역감자된장국', '바지락감자된장국', '버섯감자된장국', '상추감자된장국', '새송이감자된장국', '쇠고기감자된장국', '시금치감자된장국', '쑥감자된장국', '아욱감자된장국', '애느타리감자된장국', '애호박감자된장국', '얼갈이감자된장국', '얼큰감자된장국', '열무감자된장국', '우렁감자된장국', '우렁살감자된장국', '우렁살달래감자된장국', '우렁이감자된장국', '유부감자된장국', '조갯살아욱감자된장국', '조갯살호박감자된장국', '죽순감자된장국', '차돌박이감자된장국', '청량고추감자된장국', '친환경근대감자된장국', '팽이감자된장국', '팽이버섯감자된장국', '표고버섯감자된장국', '풋호박감자된장국', '풋호박낙지감자된장국', '하지감자된장국', '호박감자된장국', '호박잎감자된장국']
오리불고기: ['오리불고기야채볶음']
삼겹살구이: ['삼겹살구이와야채겉절이']
뱅어포구이: ['감자뱅어포구이', '고추장뱅어포구이', '매운뱅어포구이', '뱅어포구이', '아몬드뱅어포구이']
돼지불고기: ['돼지불고기화이타']
고등어구이: ['고등어구이와양념장']
가자미구이: ['가자미구이', '갈릭버터가자미구이', '고추장가자미구이', '깐풍가자미구이', '데리야끼가자미구이', '레몬가자미구이', '레몬데리야끼가자미구이', '레몬버터가자미구이', '레몬순살가자미구이', '마늘버터가자미구이', '마늘소스가자미구이', '마늘참가자미구이', '마요네즈소스와가자미구이', '말린가자미구이', '매운가자미구이', '매콤가자미구이', '무뼈가자미구이', '미니가자미구이', '바베큐가자미구이', '바질가자미구이', '바질포테이토가자미구이', '버터가자미구이', '살짝건조가자미구이', '순살가자미구이', '순살카레가자미구이', '순살허니버터가자미구이', '완두가자미구이', '완두콩가자미구이', '완두콩과순살가자미구이', '유자소스가자미구이', '칠리가자미구이', '칠리소스가자미구이', '카레가자미구이', '카레맛가자미구이', '카레통가자미구이', '크런치가자미구이', '크림소스가자미구이', '통살가자미구이', '파슬리가자미구이', '파채소스가자미구이', '포테이토가자미구이', '허니버터가자미구이', '허니버터포테이토가자미구이', '허브가자미구이', '허브솔트가자미구이', '홀그레인머스터드가자미구이']
치즈돈가스: ['치즈돈가스오븐구이']
안심돈가스: ['안심돈가스랑']
등심돈가스: ['등심돈가스오븐구이']
고구마튀김: ['고구마튀김맛탕']
고구마맛탕: ['고구마맛탕아몬드']
조기매운탕: ['조기매운탕']
우럭매운탕: ['생우럭매운탕', '우럭매운탕']
메기매운탕: ['메기매운탕']
대구지리탕: ['대구지리탕', '맑은대구지리탕', '순살대구지리탕', '참대구지리탕']
광어매운탕: ['광어매운탕']
가자미조림: ['가자미조림', '건가자미조림', '순살가자미조림', '쑥가자미조림']
호박부침개: ['건새우애호박부침개', '바삭한풋호박부침개', '부추애호박부침개', '새우호박부침개', '애호박부침개', '호박부침개']
녹두빈대떡: ['녹두빈대떡전']
소고기산적: ['소고기산적구이']
매실장아찌: ['매실장아찌야채무침']
치즈케이크: ['치즈케이크샐러드']
채소고로케: ['채소고로케']
찹쌀도우넛: ['고구마찹쌀도우넛', '뽕잎찹쌀도우넛', '우리밀찹쌀도우넛', '우리밀팥찹쌀도우넛', '찹쌀도우넛', '팥찹쌀도우넛']
불고기피자: ['불고기피자오븐구이']
버터크림빵: ['딸기버터크림빵', '버터크림빵', '앙버터크림빵']
주꾸미볶음: ['주꾸미볶음스파게티']
오삼불고기: ['오삼불고기진레']
소세지볶음: ['브로콜리소세지볶음밥']
해물볶음밥: ['굴소스해물볶음밥', '굴소해물볶음밥', '나시고랭해물볶음밥', '날치알해물볶음밥', '데리야끼해물볶음밥', '매운해물볶음밥', '매콤해물볶음밥', '모듬해물볶음밥', '미니해물볶음밥', '브로콜리해물볶음밥', '사천식해물볶음밥', '사천해물볶음밥', '상하이해물볶음밥', '새우살해물볶음밥', '새우해물볶음밥', '소시지해물볶음밥', '숙주해물볶음밥', '숯불해물볶음밥', '스페인식해물볶음밥', '양송이해물볶음밥', '오리엔탈해물볶음밥', '오징어먹물해물볶음밥', '중국식해물볶음밥', '중화소스해물볶음밥', '중화풍해물볶음밥', '지지고해물볶음밥', '채소계란굴소스해물볶음밥', '채소굴소스해물볶음밥', '철판해물볶음밥', '칠리해물볶음밥', '카레해물볶음밥', '파인애플해물볶음밥', '파인해물볶음밥', '파프리카해물볶음밥', '해물볶음밥', '후리카케해물볶음밥', '훈제오리해물볶음밥']
소고기김밥: ['셀프소고기김밥', '소고기김밥']
소고기국밥: ['대구소고기국밥', '말죽거리소고기국밥', '맛남의광장소고기국밥', '백종원소고기국밥', '삼뿌리소고기국밥', '소고기국밥', '얼큰소고기국밥', '우리소고기국밥', '장터소고기국밥']
샐러드김밥: ['돈까스샐러드김밥', '샐러드김밥', '참치샐러드김밥', '크래미샐러드김밥']
새우튀김롤: ['새우튀김롤또띠아']
삼선볶음밥: ['삼선볶음밥']
멸치주먹밥: ['감태멸치주먹밥', '건파래잔멸치주먹밥', '검은깨멸치주먹밥', '검은깨잔멸치주먹밥', '견과류멸치주먹밥', '고소한멸치주먹밥', '고추멸치주먹밥', '고추장멸치주먹밥', '고추장잔멸치주먹밥', '김가루멸치주먹밥', '김가루잔멸치주먹밥', '김가루지리멸치주먹밥', '김멸치주먹밥', '김밥멸치주먹밥', '김자반멸치주먹밥', '날치알멸치주먹밥', '돌자반멸치주먹밥', '두부멸치주먹밥', '땡초멸치주먹밥', '땡초잔멸치주먹밥', '매운멸치주먹밥', '매운어묵멸치주먹밥', '매운잔멸치주먹밥', '매콤멸치주먹밥', '멸치주먹밥', '뮤즐리멸치주먹밥', '미니멸치주먹밥', '미니잔멸치주먹밥', '바삭멸치주먹밥', '바싹멸치주먹밥', '밥새우멸치주먹밥', '보리멸치주먹밥', '볶음멸치주먹밥', '뼈튼튼멸치주먹밥', '삼각멸치주먹밥', '삼색멸치주먹밥', '새우멸치주먹밥', '세멸치주먹밥', '셀프멸치주먹밥', '셀프잔멸치주먹밥', '소고기잔멸치주먹밥', '쇠고기멸치주먹밥', '아몬드멸치주먹밥', '야채볶음멸치주먹밥', '우엉멸치주먹밥', '우엉잔멸치주먹밥', '잔멸치주먹밥', '저염멸치주먹밥', '지리멸치주먹밥', '청량고추멸치주먹밥', '청양고추멸치주먹밥', '청양멸치주먹밥', '칼슘멸치주먹밥', '통들깨멸치주먹밥', '파래멸치주먹밥', '파래볶음멸치주먹밥', '파래자반멸치주먹밥', '후리가께멸치주먹밥', '후리가케멸치주먹밥', '후리가케잔멸치주먹밥', '후리카케멸치주먹밥', '후리카케잔멸치주먹밥', '흑미멸치주먹밥', '흑미잔멸치주먹밥', '흑임자잔멸치주먹밥']
류산슬덮밥: ['류산슬덮밥']
청포묵무침: ['간단청포묵무침', '김가루청포묵무침', '김치청포묵무침', '느타리청포묵무침', '도토리묵청포묵무침', '도토리청포묵무침', '돌나물청포묵무침', '떡갈비청포묵무침', '묵은지청포묵무침', '미나리청포묵무침', '방울토마토청포묵무침', '버섯청포묵무침', '비트청포묵무침', '삼색청포묵무침', '새싹청포묵무침', '쇠고기청포묵무침', '수제삼색청포묵무침', '숙주나물청포묵무침', '숙주청포묵무침', '시금치청포묵무침', '신김치청포묵무침', '쑥갓청포묵무침', '어린잎청포묵무침', '오이게맛살청포묵무침', '우민찌청포묵무침', '이색청포묵무침', '참나물청포묵무침', '청포묵무침', '취나물청포묵무침', '치자청포묵무침', '치커리청포묵무침', '컬러청포묵무침', '토마토청포묵무침', '통들깨청포묵무침', '파프리카청포묵무침', '한우채청포묵무침', '황해도식청포묵무침', '훈제오리청포묵무침', '흑임자청포묵무침']
단무지무침: ['가쓰오꼬들단무지무침', '가쓰오단무지무침', '게맛살단무지무침', '고들단무지무침', '국산단무지무침', '김밥단무지무침', '깍둑단무지무침', '깻잎단무지무침', '깻잎채단무지무침', '꼬꼬들단무지무침', '꼬들꼬들단무지무침', '꼬들단무지무침', '꼬들이단무지무침', '꼬들치자단무지무침', '꼬들한유자단무지무침', '꼬마단무지무침', '나트륨감소된단무지무침', '노랑단무지무침', '단무지무침', '달래단무지무침', '땡초단무지무침', '락교단무지무침', '레몬꼬들단무지무침', '레몬단무지무침', '매실오이꼬들단무지무침', '매운단무지무침', '매운쫄단무지무침', '매콤꼬들단무지무침', '매콤단무지무침', '매콤반달단무지무침', '매콤스틱단무지무침', '모양단무지무침', '무농약단무지무침', '무농약백색단무지무침', '무장아찌단무지무침', '무첨가단무지무침', '반달단무지무침', '방단무지무침', '백단무지무침', '백색단무지무침', '부채단무지무침', '부채모양단무지무침', '부추꼬들단무지무침', '부추단무지무침', '빨간단무지무침', '사각단무지무침', '사과단무지무침', '사랑해단무지무침', '삼색묵꼬들단무지무침', '새콤꼬들단무지무침', '새콤달콤단무지무침', '셀러리단무지무침', '송송단무지무침', '숙주단무지무침', '스틱단무지무침', '슬라이스단무지무침', '슬림단무지무침', '슬림반달단무지무침', '실파단무지무침', '심쿵하트포함단무지무침', '씬단무지무침', '아삭단무지무침', '아삭반달단무지무침', '양념단무지무침', '양파꼬들단무지무침', '양파단무지무침', '옛날단무지무침', '오복채단무지무침', '오이꼬들단무지무침', '오이단무지무침', '오이유자단무지무침', '오이지꼬들단무지무침', '오이지단무지무침', '오이피클단무지무침', '우리무단무지무침', '유자꼬들단무지무침', '유자단무지무침', '유자채단무지무침', '잔파단무지무침', '저염꼬들단무지무침', '저염단무지무침', '중국식단무지무침', '짜사이단무지무침', '짜사이식단무지무침', '쪼글단무지무침', '쪼글이단무지무침', '쪽파단무지무침', '쫄깃단무지무침', '쫄깃치자단무지무침', '쫄단무지무침', '참깨꼬들단무지무침', '참나물단무지무침', '채단무지무침', '치자꼬들단무지무침', '치자단무지무침', '치자쫄깃단무지무침', '콩나물단무지무침', '콩나물유자단무지무침', '토마토단무지무침', '파송송단무지무침', '파인애플단무지무침', '파채단무지무침', '파프리카단무지무침', '피망단무지무침', '하트단무지무침', '한입단무지무침', '후리가케꼬들단무지무침', '후리가케단무지무침', '후리카케단무지무침', '흑임자단무지무침', '흑임자반달단무지무침']
골뱅이무침: ['골뱅이무침회']
해물칼국수: ['가리비해물칼국수', '궁중해물칼국수', '김치해물칼국수', '꽃게해물칼국수', '낙지해물칼국수', '느타리버섯해물칼국수', '대하해물칼국수', '미니해물칼국수', '미더덕해물칼국수', '바지락해물칼국수', '보말해물칼국수', '소고기해물칼국수', '얼큰낙지해물칼국수', '얼큰이해물칼국수', '얼큰해물칼국수', '우리밀해물칼국수', '전복해물칼국수', '칼칼한해물칼국수', '해물칼국수', '해초해물칼국수', '홍합해물칼국수']
삼선자장면: ['삼선자장면']
수수부꾸미: ['수수부꾸미전']
녹두시루떡: ['녹두시루떡']
미나리나물: ['미나리나물무침', '숙주미나리나물무침']
해파리냉채: ['해파리냉채무침']
황태해장국: ['두부황태해장국', '사골황태해장국', '콩나물황태해장국', '황태해장국']
홍합미역국: ['건홍합미역국', '굴홍합미역국', '들깨홍합미역국', '마른홍합미역국', '바지락살홍합미역국', '생홍합미역국', '쇠고기홍합미역국', '알홍합미역국', '피홍합미역국', '홍합미역국']
우렁된장국: ['건호박우렁된장국', '근대우렁된장국', '냉이우렁된장국', '논우렁된장국', '단배추우렁된장국', '달래우렁된장국', '두부우렁된장국', '무청우렁된장국', '버섯우렁된장국', '산나물우렁된장국', '새송이우렁된장국', '소고기우렁된장국', '시금치우렁된장국', '시래기우렁된장국', '아욱우렁된장국', '애호박우렁된장국', '얼갈이우렁된장국', '우렁된장국', '죽순우렁된장국', '친환경우렁된장국', '팽이버섯우렁된장국', '표고우렁된장국', '호박두부우렁된장국', '호박우렁된장국', '호박팽이우렁된장국']
소고기무국: ['감자소고기무국', '갱상도식소고기무국', '경상도소고기무국', '경상도식소고기무국', '경상도식얼큰소고기무국', '경상도식한우소고기무국', '두부소고기무국', '맑은소고기무국', '매운소고기무국', '매콤소고기무국', '매콤한우소고기무국', '북어소고기무국', '빨간소고기무국', '생당면소고기무국', '소고기무국', '얼큰소고기무국', '얼큰한소고기무국', '얼큰한우소고기무국', '콩나물소고기무국', '한방소고기무국', '한우소고기무국']
미소된장국: ['가다랑어미소된장국', '감자미소된장국', '냉이미소된장국', '다시마미소된장국', '대파미소된장국', '두부넣은미소된장국', '두부미소된장국', '두부미역미소된장국', '두부팽이미소된장국', '두부팽이버섯미소된장국', '들깨미소된장국', '맑은무미소된장국', '맑은미소된장국', '미소된장국', '미역두부미소된장국', '미역미소된장국', '바지락미소된장국', '버섯미소된장국', '부추미소된장국', '선택미소된장국', '순두부미소된장국', '시금치미소된장국', '실파미소된장국', '쑥갓미소된장국', '아욱미소된장국', '알배추미소된장국', '야채미소된장국', '양배추미소된장국', '양송이미소된장국', '얼갈이미소된장국', '연두부미소된장국', '유부넣은미소된장국', '유부미소된장국', '유부미역미소된장국', '유부파미소된장국', '유부팽이미소된장국', '일식미소된장국', '쪽파미소된장국', '참나물미소된장국', '파미소된장국', '파송송미소된장국', '팽이두부미소된장국', '팽이미소된장국', '팽이미역미소된장국', '팽이버섯두부미소된장국', '팽이버섯미소된장국', '팽이유부미소된장국', '표고버섯미소된장국', '호박미소된장국']
맑은감자국: ['다시마맑은감자국', '맑은감자국', '새우살맑은감자국', '유부맑은감자국', '친환경맑은감자국']
임연수구이: ['갈릭버터임연수구이', '갈릭소이임연수구이', '갈릭임연수구이', '데리야끼임연수구이', '로즈마리임연수구이', '마늘소스임연수구이', '매콤데리야끼임연수구이', '매콤임연수구이', '바베큐임연수구이', '바싹임연수구이', '버터갈릭임연수구이', '뼈없는임연수구이', '순살임연수구이', '유자소스임연수구이', '유자청임연수구이', '임연수구이', '청양마요임연수구이', '카레임연수구이']
치킨너겟: ['치킨너겟엿장조림']
채소튀김: ['뿌리채소튀김우동', '채소튀김오꼬노미야끼']
새우튀김: ['새우튀김우동면']
미역튀각: ['건미역튀각', '미역튀각']
감자튀김: ['감자튀김치즈']
풋고추찜: ['풋고추찜무침']
코다리찜: ['간장양념순살코다리찜', '매운코다리찜', '매콤코다리찜', '명태코다리찜', '북어코다리찜', '새우코다리찜', '순살코다리찜', '시래기코다리찜', '연근코다리찜', '코다리찜', '콩나물코다리찜']
애호박찜: ['애호박찜나물']
쇠갈비찜: ['매콤쇠갈비찜', '산약쇠갈비찜', '쇠갈비찜', '한우쇠갈비찜']
오리백숙: ['녹두누룽지오리백숙', '녹두오리백숙', '누룽지오리백숙', '능이오리백숙', '부추오리백숙', '새송이오리백숙', '송이오리백숙', '영양오리백숙', '오리백숙', '전복오리백숙', '표고오리백숙', '한방누룽지오리백숙', '황기무항생제오리백숙']
부대찌개: ['부대찌개스파게티']
버섯전골: ['버섯전골찌개']
된장찌개: ['꽃게오만디된장찌개', '냉이호박된장찌개', '딱새우해물된장찌개', '멜젓소스두부고기된장찌개', '뻑뻑한우렁살된장찌개', '애호박우렁이된장찌개', '우렁바지락살된장찌개', '우렁이살강된장찌개', '차돌배기애호박된장찌개']
동태찌개: ['동태찌개여']
닭볶음탕: ['간장닭볶음탕', '간장소스닭볶음탕', '간장순살닭볶음탕', '감자닭볶음탕', '고구마닭볶음탕', '고사리닭볶음탕', '고추장닭볶음탕', '곱창닭볶음탕', '국물김치닭볶음탕', '국물닭볶음탕', '국물분모자닭볶음탕', '국물있는닭볶음탕', '국물자작닭볶음탕', '굴소스닭볶음탕', '김치닭볶음탕', '김치매운닭볶음탕', '까르보불닭볶음탕', '깻잎닭볶음탕', '깻잎들깨닭볶음탕', '꽃게닭볶음탕', '꽈리고추닭볶음탕', '낙지닭볶음탕', '납작당면닭볶음탕', '넓적당면닭볶음탕', '뇨끼닭볶음탕', '눈꽃치즈닭볶음탕', '단호박닭볶음탕', '단호박매운닭볶음탕', '닭다리닭볶음탕', '닭볶음탕', '당면닭볶음탕', '대파닭볶음탕', '데리야끼닭볶음탕', '두반장닭볶음탕', '들깨닭볶음탕', '등갈비닭볶음탕', '땡초닭볶음탕', '떡닭볶음탕', '뚝배기닭볶음탕', '로제닭볶음탕', '마늘닭볶음탕', '마늘듬뿍닭볶음탕', '마늘많이닭볶음탕', '마라닭볶음탕', '마라당면닭볶음탕', '마라불닭볶음탕', '마라소스닭볶음탕', '매운고구마닭볶음탕', '매운닭볶음탕', '매운소스닭볶음탕', '매콤간장닭볶음탕', '매콤감자닭볶음탕', '매콤닭볶음탕', '매콤크림닭볶음탕', '매콤한방닭볶음탕', '모둠떡닭볶음탕', '무채닭볶음탕', '무항생제닭볶음탕', '묵은지국물닭볶음탕', '묵은지닭볶음탕', '묵은지매운닭볶음탕', '묵은지순살닭볶음탕', '미나리닭볶음탕', '바베큐닭볶음탕', '방울순대닭볶음탕', '백종원닭볶음탕', '분모자닭볶음탕', '분모자마라닭볶음탕', '불닭맛닭볶음탕', '불닭볶음탕', '비벼먹는순살닭볶음탕', '빨간닭볶음탕', '빨간양념닭볶음탕', '뼈닭볶음탕', '뼈없는닭볶음탕', '뼈있는닭볶음탕', '사천마라닭볶음탕', '사천짜장닭볶음탕', '수제비닭볶음탕', '수제비떡닭볶음탕', '숙주닭볶음탕', '순살국물닭볶음탕', '순살닭볶음탕', '순살로만든닭볶음탕', '순살묵은지닭볶음탕', '숯불닭볶음탕', '시래기닭볶음탕', '시래기묵은지닭볶음탕', '신김치닭볶음탕', '알감자닭볶음탕', '알감자순살닭볶음탕', '알품은닭볶음탕', '양념고구마닭볶음탕', '어깨살닭볶음탕', '얼큰닭볶음탕', '엽기닭볶음탕', '옛날닭볶음탕', '자장닭볶음탕', '전복닭볶음탕', '중국당면닭볶음탕', '짜장닭볶음탕', '짜장매운닭볶음탕', '쫄면닭볶음탕', '쭈닭볶음탕', '차돌닭볶음탕', '청양닭볶음탕', '청양풍닭볶음탕', '춘천식닭볶음탕', '치즈닭볶음탕', '치즈떡닭볶음탕', '치즈순살닭볶음탕', '친환경닭볶음탕', '카레닭볶음탕', '카레순살닭볶음탕', '카레향닭볶음탕', '커리닭볶음탕', '탄두리닭볶음탕', '토마토닭볶음탕', '통마늘닭볶음탕', '한그릇닭볶음탕', '해물닭볶음탕']
낙지전골: ['낙지전골', '돈육낙지전골', '두부낙지전골', '불고기낙지전골', '소고기낙지전골', '소불고기낙지전골', '쇠고기낙지전골', '쇠고기버섯낙지전골', '우불고기낙지전골', '한우낙지전골', '한우불고기낙지전골']
김치전골: ['김치전골', '낙지김치전골', '닭김치전골', '돼지갈비김치전골', '돼지김치전골', '두부스팸김치전골', '두부햄김치전골', '등뼈김치전골', '만두김치전골', '만두버섯김치전골', '모둠김치전골', '목살김치전골', '버섯김치전골', '불고기김치전골', '손만두돼지김치전골', '쇠고기김치전골', '어묵김치전골', '옹심이김치전골', '왕만두김치전골', '참치김치전골', '한그릇김치전골', '햄김치전골']
갈치찌개: ['갈치찌개']
흑임자죽: ['고소흑임자죽', '대추흑임자죽', '흑임자죽']
쇠고기죽: ['쇠고기죽순불고기']
쥐포조림: ['견과류쥐포조림', '고추장쥐포조림', '구운쥐포조림', '꼬마쥐포조림', '나비쥐포조림', '눌린쥐포조림', '동전쥐포조림', '땅콩쥐포조림', '마늘종쥐포조림', '매콤쥐포조림', '사각쥐포조림', '살쥐포조림', '새끼쥐포조림', '실파쥐포조림', '아기쥐포조림', '아몬드동전쥐포조림', '아몬드사각쥐포조림', '아몬드쥐포조림', '우엉쥐포조림', '줄쥐포조림', '쥐포조림', '찢은쥐포조림', '참쥐포조림', '찹쌀콩쥐포조림', '통쥐포조림']
우엉조림: ['간장우엉조림', '감자우엉조림', '건새우우엉조림', '건포도우엉조림', '검은콩우엉조림', '검정깨우엉조림', '검정콩우엉조림', '견과류우엉조림', '견과우엉조림', '고구마우엉조림', '고추장진미우엉조림', '곤약우엉조림', '꽈리고추우엉조림', '다시마우엉조림', '다시마채우엉조림', '돈육우엉조림', '돈육채우엉조림', '돈채우엉조림', '돼지고기우엉조림', '들깨우엉조림', '땅콩우엉조림', '마늘쫑우엉조림', '맛살우엉조림', '매운우엉조림', '매추리알우엉조림', '매콤건문어우엉조림', '매콤우엉조림', '매콤한우엉조림', '메란우엉조림', '메추리알우엉조림', '멸치우엉조림', '명엽채우엉조림', '무항생제한우우엉조림', '무화과우엉조림', '미트볼우엉조림', '볼어묵우엉조림', '비엔나우엉조림', '새송이우엉조림', '생땅콩우엉조림', '소고기우엉조림', '쇠고기어슷우엉조림', '쇠고기우엉조림', '씨앗우엉조림', '아몬드우엉조림', '어묵우엉조림', '어묵채우엉조림', '어슷우엉조림', '엇우엉조림', '연근땅콩우엉조림', '연근우엉조림', '오징어채우엉조림', '오징어포우엉조림', '완자어묵우엉조림', '우엉조림', '우엉조림주먹밥', '일미우엉조림', '잔멸치우엉조림', '조랭이떡우엉조림', '쥐채우엉조림', '쥐포우엉조림', '진미채우엉조림', '쫄쫄이어묵우엉조림', '캐슈넛우엉조림', '크랜베리우엉조림', '통우엉조림', '파프리카우엉조림', '표고우엉조림', '표고편우엉조림', '한우우엉조림', '햄우엉조림', '호두살우엉조림', '호두우엉조림', '호박씨우엉조림', '혼합멸치우엉조림', '홍고추우엉조림']
연근조림: ['연근조림여']
어묵조림: ['메란완자어묵조림', '알감자부들어묵조림']
삼치조림: ['건시래기삼치조림', '고구마줄기삼치조림', '깻잎삼치조림', '데리야끼삼치조림', '된장삼치조림', '두반장삼치조림', '레몬간장삼치조림', '묵은지삼치조림', '삼치조림', '시래기삼치조림', '양념순살삼치조림', '칠리삼치조림']
병어조림: ['감자병어조림', '병어조림', '죽순병어조림', '호박병어조림']
버섯조림: ['가마보꼬버섯조림', '갈릭미트볼버섯조림', '갈비맛떡갈비버섯조림', '갈비산적버섯조림', '감자버섯조림', '감자새송이버섯조림', '고기산적버섯조림', '곤약메란버섯조림', '곤약메추리알버섯조림', '곤약버섯조림', '곤약새송이버섯조림', '까르보미트볼버섯조림', '꼬마새송이버섯조림', '꽈리고추버섯조림', '꽈리고추새송이버섯조림', '너비아니버섯조림', '느타리버섯조림', '달걀모듬버섯조림', '달걀버섯조림', '닭가슴살버섯조림', '닭고기버섯조림', '닭밤버섯조림', '닭살버섯조림', '닭안심표고버섯조림', '데리야끼새송이버섯조림', '돈사태버섯조림', '돈육메추리알버섯조림', '돈육버섯조림', '돈육새송이버섯조림', '돈육알버섯조림', '돈육콩송이버섯조림', '동그랑땡버섯조림', '돼지고기버섯조림', '두부버섯조림', '두부완자버섯조림', '두부팽이버섯조림', '두유소버섯조림', '떡갈비버섯조림', '떡갈비산적버섯조림', '떡갈비새송이버섯조림', '매운팽이버섯조림', '매콤돈사태버섯조림', '매콤모둠버섯조림', '매콤새송이버섯조림', '매콤팽이버섯조림', '메란버섯조림', '메알버섯조림', '메추리알모듬버섯조림', '메추리알미니새송이버섯조림', '메추리알버섯조림', '메추리알새송이버섯조림', '메추리알새송이이버섯조림', '메추리알콩알버섯조림', '메추리알표고버섯조림', '모둠버섯조림', '모듬버섯조림', '무미트버섯조림', '무버섯조림', '미니새송이버섯조림', '미트볼버섯조림', '버섯조림', '베지볼버섯조림', '볼비엔나버섯조림', '볼어묵버섯조림', '부들어묵버섯조림', '불닭소스버섯조림', '불닭팽이버섯조림', '비엔나메추리알버섯조림', '비엔나새송이버섯조림', '비엔나표고버섯조림', '새송이버섯조림', '새알만두버섯조림', '소고기팽이버섯조림고', '솎음버섯조림', '송이버섯조림', '쇠고기새송이버섯조림', '시금치버섯조림', '알새송이버섯조림', '애기새송이버섯조림', '애새송이버섯조림', '양송이버섯조림', '어묵버섯조림', '연근버섯조림', '오징어버섯조림', '완자버섯조림', '우엉버섯조림', '우엉새송이버섯조림', '우엉채파프리카버섯조림', '작은새송이버섯조림', '잡채어묵버섯조림', '직화산적버섯조림', '총알버섯조림', '치즈떡갈비메추리알버섯조림', '치즈미트볼버섯조림', '통달걀버섯조림', '팽이버섯조림', '표고버섯조림', '한우양송이버섯조림', '한입떡갈비버섯조림', '함박버섯조림', '해물완자버섯조림', '호박표고버섯조림']
멸치조림: ['멸치조림장']
땅콩조림: ['갈비떡땅콩조림', '감자땅콩조림', '강낭콩땅콩조림', '건강혼합멸치땅콩조림', '건새우땅콩조림', '건새우호두땅콩조림', '검은콩땅콩조림', '검정콩땅콩조림', '고구마땅콩조림', '고추부각땅콩조림', '곤약땅콩조림', '구운쥐포채땅콩조림', '구이쥐포땅콩조림', '국산생땅콩조림', '국산연근땅콩조림', '노랑콩땅콩조림', '다시마땅콩조림', '단호박메추리알땅콩조림', '닭강정땅콩조림', '담양버섯갈비땅콩조림', '동전쥐포땅콩조림', '두절새우땅콩조림', '땅콩조림', '떡갈비땅콩조림', '마늘땅콩조림', '맑은연근땅콩조림', '맑은우엉땅콩조림', '맛진미땅콩조림', '맛탕단호박땅콩조림', '메추리알땅콩조림', '멸치땅콩조림', '멸치생땅콩조림', '명엽채땅콩조림', '명엽채생땅콩조림', '명엽채아몬드땅콩조림', '명태피땅콩조림', '무화과땅콩조림', '미트볼땅콩조림', '밤땅콩조림', '방울떡땅콩조림', '뱅어포땅콩조림', '병아리콩땅콩조림', '볶은땅콩조림', '볼어묵땅콩조림', '부들어묵땅콩조림', '비엔나땅콩조림', '비엔나생땅콩조림', '사각쥐포땅콩조림', '살쥐포채땅콩조림', '삼발소스땅콩조림', '새송이땅콩조림', '생땅콩조림', '서리태땅콩조림', '속청콩땅콩조림', '실치땅콩조림', '아몬드땅콩조림', '알감자땅콩조림', '알땅콩조림', '어묵땅콩조림', '어묵볼땅콩조림', '어슷우엉땅콩조림', '연근땅콩조림', '연근물엿땅콩조림', '연근생땅콩조림', '연근우엉땅콩조림', '연근호두땅콩조림', '영양땅콩조림', '오징어땅콩조림', '오징어버터채땅콩조림', '오징어채땅콩조림', '완자어묵땅콩조림', '우엉땅콩조림', '우엉부각땅콩조림', '우엉생땅콩조림', '우엉은행땅콩조림', '우엉채땅콩조림', '우엉편땅콩조림', '일미땅콩조림', '일미포땅콩조림', '잔멸치땅콩조림', '쥐어채땅콩조림', '쥐채땅콩조림', '쥐치땅콩조림', '쥐치포땅콩조림', '쥐포땅콩조림', '쥐포채땅콩조림', '진미땅콩조림', '진미채땅콩조림', '진미채볶은땅콩조림', '캐슈넛땅콩조림', '콩땅콩조림', '콩자반땅콩조림', '햄땅콩조림', '햄연근땅콩조림', '호두땅콩조림', '호두멸치땅콩조림', '호두생땅콩조림', '흑태땅콩조림', '흰콩땅콩조림']
두부조림: ['다진돼지고기두부조림', '돈다짐두부조림', '돈육두부조림덮밥', '미트소스두부조림덮밥']
꽁치조림: ['건시래기꽁치조림', '건학꽁치조림', '곤드레꽁치조림', '김치꽁치조림', '김치말이꽁치조림', '꽁치조림', '묵은지꽁치조림', '뼈없는꽁치조림', '뼈째먹는꽁치조림', '시래기꽁치조림', '신김치꽁치조림', '우거지꽁치조림', '일식꽁치조림', '캔꽁치조림', '통조림꽁치조림', '학꽁치조림']
감자조림: ['감자조림부흥', '닭감자조림고추장조림', '매운감자조림돈육', '스팸감자조림짜글이', '알감자조림여', '약고추장어묵감자조림']
갈치조림: ['갈치조림', '감자갈치조림', '고구마대갈치조림', '고구마순갈치조림', '고구마줄기갈치조림', '남대문갈치조림', '단호박갈치조림', '둥근호박갈치조림', '매콤갈치조림', '뼈없는갈치조림', '순살갈치조림', '시래기갈치조림', '애호박갈치조림', '친환경감자갈치조림', '칼칼갈치조림', '호박갈치조림']
오징어젓: ['오징어젓무말랭이지무침']
양념게장: ['양념게장무침']
해물파전: ['해물파전오꼬노이야끼']
애호박전: ['애호박전병']
두부부침: ['두부부침양념장']
달걀말이: ['달걀말이토스트']
고구마전: ['고구마전두부티라미슈']
미숫가루: ['미숫가루쌈장']
해초무침: ['게맛살해초무침', '꼬들꼬들해초무침', '꼬막해초무침', '꼬시래기해초무침', '두부곤약해초무침', '레몬해초무침', '맛살해초무침', '모둠해초무침', '모듬해초무침', '무채해초무침', '미역해초무침', '새콤해초무침', '생해초무침', '실곤약모듬해초무침', '실곤약해초무침', '양배추해초무침', '오리엔탈해초무침', '오이맛살해초무침', '오이해초무침', '오징어해초무침', '와사비해초무침', '천사채해초무침', '토마토해초무침', '톳나물해초무침', '편육해초무침', '해초무침']
파래무침: ['무파래무침교직원']
오이생채: ['부추오이생채겉절이', '상추오이생채무침', '오이생채무침', '치커리오이생채나물']
부추무침: ['백다다기영양부추무침', '부추무침과']
달래무침: ['가을달래무침', '건파래달래무침', '고추장달래무침', '골뱅이달래무침', '김자반달래무침', '꼬막달래무침', '냉이달래무침', '녹두묵달래무침', '단무지달래무침', '달래무침', '도라지달래무침', '도토리달래무침', '도토리묵달래무침', '돈나물달래무침', '돌나물달래무침', '두부달래무침', '매실청달래무침', '무달래무침', '무말랭이달래무침', '배달래무침', '봄달래무침', '봄동달래무침', '봄동부추달래무침', '봄배추달래무침', '부추달래무침', '부추오이달래무침', '사과달래무침', '사과오이달래무침', '상추달래무침', '세발나물달래무침', '세발달래무침', '소라달래무침', '스틱오이달래무침', '시금치달래무침', '시금치오징어달래무침', '쑥갓달래무침', '얼갈이달래무침', '연두부달래무침', '연배추달래무침', '오이고추장달래무침', '오이달래무침', '오이돗나물달래무침', '오이봄달래무침', '오이부추달래무침', '오이사과달래무침', '오이우렁이달래무침', '자반달래무침', '주꾸미달래무침', '참나물달래무침', '청오이달래무침', '청포묵달래무침', '치커리달래무침', '콜라비달래무침', '콩나물달래무침', '파래달래무침', '한입두부달래무침', '향긋한달래무침']
낙지무침: ['골뱅이낙지무침', '낙지무침', '오징어낙지무침']
굴무생채: ['굴무생채', '생굴무생채']
크로아상: ['크로아상샌드위치']
카스텔라: ['카스텔라찹쌀경단']
치킨버거: ['치킨버거셋트']
찹쌀도넛: ['송사부쫀득찹쌀도넛', '찹쌀도넛핫도그']
소보로빵: ['고구마소보로빵', '고소함소보로빵', '과일생크림소보로빵', '단팥소보로빵', '달콤바삭소보로빵', '딸기생크림소보로빵', '맛보로소보로빵', '모카생크림과일소보로빵', '모카소보로빵', '생과일모카소보로빵', '생크림과일소보로빵', '생크림소보로빵', '셀프소보로빵햄버거', '소보로빵', '수제미니딸기소보로빵', '수제크림소보로빵', '슈크림소보로빵', '옥수수소보로빵', '우리밀단팥튀김소보로빵', '우리밀땅콩소보로빵', '우리밀생크림소보로빵', '우리밀소보로빵햄버거', '찰소보로빵', '카스테라소보로빵', '크림가득소보로빵', '크림소보로빵', '크림치즈소보로빵', '튀김소보로빵']
사과파이: ['국산사과파이', '꽃사과파이', '달콤사과파이', '미니사과파이', '볼빨간사과파이', '사과파이', '상큼사과파이', '수제미니사과파이', '수제사과파이', '수제치즈사과파이', '애플턴오버사과파이', '오븐에구운사과파이', '오븐에구운우리밀사과파이', '우리밀사과파이', '우리사과파이', '직접구운사과파이', '직접구운호밀사과파이', '촉촉한사과파이', '치즈사과파이', '친환경사과파이', '페스츄리사각사과파이', '페스츄리사과파이', '호밀들어간사과파이', '호밀사과파이', '호밀우리사과파이', '호밀이들어간사과파이', '호밀이들어간우리사과파이']
롤케이크: ['끼리치즈미니롤케이크', '끼리크림치즈롤케이크손하트', '떠먹는롤케이크플레인', '롤케이크위에마카롱', '생일축하수제화이트롤케이크', '쇼콜라초코롤케이크', '우리밀롤케이크마카롱']
제육볶음: ['제육볶음어묵덮밥']
어묵잡채: ['어묵잡채말이']
어묵볶음: ['간장부들어묵볶음', '곤약부들어묵볶음', '꽈리고추부들어묵볶음', '꽈리구운어묵볶음', '마늘쫑부들어묵볶음', '매콤어묵볶음주먹밥', '브로콜리부들어묵볶음', '비엔나부들어묵볶음', '새송이부들어묵볶음', '양파부들어묵볶음', '어묵볶음고추장', '콩줄기우엉어묵볶음', '피망구운어묵볶음']
양파볶음: ['양파볶음소스']
새우볶음: ['가지애호박새우볶음', '갈릭마요새우볶음', '갈릭버터새우볶음', '감자새우볶음', '건밥새우볶음', '건파래밥새우볶음', '건파래새우볶음', '견과류멸치새우볶음', '견과멸치새우볶음', '계란새우볶음', '고구마줄기새우볶음', '고추장멸치새우볶음', '김자반새우볶음', '까르보새우볶음우동', '깐쇼새우볶음', '깐쇼칠리새우볶음', '꽃새우볶음', '꽈리고추멸치새우볶음', '꽈리고추새우볶음', '낙지곱창새우볶음', '낙지돈육새우볶음', '낙지돼지고기새우볶음', '낙지불고기새우볶음', '낙지블랙타이거새우볶음', '낙지삼겹살새우볶음', '낙지삼겹새우볶음', '낙지새우볶음', '낙지소고기새우볶음', '낙지차돌새우볶음', '달걀새우볶음', '닭살새우볶음', '돈육낙지새우볶음', '돼지목살새우볶음', '두절새우볶음', '들깨머위대새우볶음', '마늘종보리새우볶음', '마늘종새우볶음', '마늘쫑깐새우볶음', '마늘쫑꽃새우볶음', '마늘쫑밥새우볶음', '마늘쫑새우볶음', '마른새우볶음', '망고새우볶음', '매콤낙지쭈꾸미새우볶음', '매콤새우볶음주먹밥', '매콤쭈낙오새우볶음', '멸치새우볶음', '밥새우볶음', '버섯새우볶음', '버터갈릭새우볶음', '베이컨새우볶음우동', '보리새우볶음', '볼어묵새우볶음', '부들어묵새우볶음', '불고기낙지새우볶음', '불낙새우볶음', '불주꾸미새우볶음', '브레디새우볶음우동', '브로컬리새우볶음', '브로콜리비엔나새우볶음', '브로콜리새우볶음', '브로콜리알새우볶음', '브로콜리양배추새우볶음', '브로콜리파프리카새우볶음', '삼겹살새우볶음', '새송이버섯새우볶음', '새우볶음', '새우볶음우동', '생새우볶음', '소고기새우볶음', '소시지새우볶음', '숙주새우볶음', '시금치새우볶음', '실치잔새우볶음', '아몬드멸치새우볶음', '아스파라거스새우볶음', '애호박밥새우볶음', '애호박새우볶음', '애호박알새우볶음', '애호박채새우볶음', '애호박칵테일새우볶음', '양배추새우볶음', '양송이새우볶음', '어묵새우볶음', '오이새우볶음', '올리브유새우볶음', '울외새우볶음', '잔멸치새우볶음', '조방낙지새우볶음', '주꾸미새우볶음', '죽순새우볶음', '지리멸치새우볶음', '진미채새우볶음', '쭈꾸미돈육새우볶음', '쭈꾸미삼겹새우볶음', '쭈꾸미새우볶음', '쭈낙새우볶음', '쭈낙오새우볶음', '찹쌀콩새우볶음', '청경채새우볶음', '치즈쏙비엔나새우볶음', '칠리깐쇼새우볶음', '칠리새우볶음', '칠리소스새우볶음', '카레새우볶음', '토마토달걀새우볶음', '풋고추새우볶음', '호박새우볶음']
멸치볶음: ['매콤꽈리초멸치볶음', '멸치볶음주먹밥']
마파두부: ['마파두부찜']
당근볶음: ['감자당근볶음', '감자채당근볶음', '건두부양배추당근볶음', '당근볶음', '멸치당근볶음', '명엽채당근볶음', '미니당근볶음밥', '미역줄기당근볶음', '볼어묵당근볶음', '브로콜리당근볶음', '새우젓호박당근볶음', '숙주당근볶음', '시금치당근볶음', '애느타리당근볶음', '애호박당근볶음', '양배추당근볶음', '어묵당근볶음', '우엉당근볶음밥', '채어묵당근볶음', '콩나물당근볶음', '호박당근볶음']
닭발볶음: ['닭발볶음', '매운닭발볶음', '매운숯불닭발볶음', '무뼈닭발볶음', '뼈가없는닭발볶음', '뼈없는닭발볶음']
낙지볶음: ['낙지볶음소스']
김치볶음: ['김치볶음소스']
고추볶음: ['가마보꼬꽈리고추볶음', '가마보꼬풋고추볶음', '가문어꽈리고추볶음', '가지꽈리고추볶음', '가지나물청양고추볶음', '가지청양고추볶음', '가지풋고추볶음', '갈치어묵고추볶음', '감자고추볶음', '감자꽈리고추볶음', '감자채풋고추볶음', '감자풋고추볶음', '건문어꽈리고추볶음', '건새우꽈리고추볶음', '건새우풋고추볶음', '건오징어꽈리고추볶음', '견과류멸치고추볶음', '고추볶음', '고추볶음장', '구멍어묵고추볶음', '구멍어묵꽈리고추볶음', '귀채꽈리고추볶음', '깐멸치꽈리고추볶음', '깐멸치홍고추볶음', '꼴뚜기꽈리고추볶음', '꽈리고추볶음', '낙지꽈리고추볶음', '느타리꽈리고추볶음', '느타리버섯꽈리고추볶음', '닭가슴살꽈리고추볶음', '닭가슴살훈제꽈리고추볶음', '닭고기고추볶음', '닭고기꽈리고추볶음', '닭꽈리고추볶음', '돈육고추볶음', '돈육꽈리고추볶음', '돼지고기고추볶음', '돼지고기꽈리고추볶음', '돼지꽈리고추볶음', '두부꽈리고추볶음', '마늘쫑고추볶음', '만가닥버섯꽈리고추볶음', '매운멸치꽈리고추볶음', '매콤고추볶음밥', '매콤어묵고추볶음', '매콤어묵꽈리고추볶음', '메추리알꽈리고추볶음', '멸치고추볶음', '멸치꽈리고추볶음', '멸치마늘풋고추볶음', '멸치매운고추볶음', '명엽채꽈리고추볶음', '명엽채풋고추볶음', '문어고추볶음', '문어꽈리고추볶음', '문어다리꽈리고추볶음', '문어포꽈리고추볶음', '미역줄기고추볶음', '미역줄기청양고추볶음', '반건조오징어꽈리고추볶음', '방울오징어고추볶음', '방울오징어꽈리고추볶음', '뱅어포고추볶음', '뱅어포꽈리고추볶음', '베이컨꽈리고추볶음', '볼어묵꽈리고추볶음', '볼어묵풋고추볶음', '봉봉어묵풋고추볶음', '부들어묵고추볶음', '부들어묵꽈리고추볶음', '부들어묵풋고추볶음', '북어채고추볶음', '북어채꽈리고추볶음', '북어채풋고추볶음', '북어포고추볶음', '비엔나꽈리고추볶음', '비엔나소시지꽈리고추볶음', '비엔나풋고추볶음', '사각어묵꽈리고추볶음', '사각어묵풋고추볶음', '삼겹살꽈리고추볶음', '삼치홍고추볶음', '새송이꽈리고추볶음', '새송이버섯꽈리고추볶음', '쇠고기고추볶음', '쇠고기꽈리고추볶음', '쇠고기풋고추볶음', '스모크햄꽈리고추볶음', '스팸고추볶음', '스팸고추볶음장', '실어묵고추볶음', '양송이꽈리고추볶음', '어묵고추볶음', '어묵꽈리고추볶음', '어묵채고추볶음', '어묵풋고추볶음', '오리정육꽈리고추볶음', '오징어꽈리고추볶음', '오징어실채꽈리고추볶음', '오징어채고추볶음', '오징어칩꽈리고추볶음', '오징어칩스꽈리고추볶음', '오징어포풋고추볶음', '완자어묵꽈리고추볶음', '완자어묵풋고추볶음', '우리밀어묵풋고추볶음', '우엉꽈리고추볶음', '우엉채청량고추볶음', '유부꽈리고추볶음', '잔멸치청양고추볶음', '저염멸치꽈리고추볶음', '종합어묵고추볶음', '주꾸미꽈리고추볶음', '중멸치꽈리고추볶음', '쥐어채꽈리고추볶음', '쥐채꽈리고추볶음', '쥐치채풋고추볶음', '쥐치포꽈리고추볶음', '지리멸치꽈리고추볶음', '지리멸치청양고추볶음', '지리멸풋고추볶음', '진미고추볶음', '진미채고추볶음', '진미채꽈리고추볶음', '청양고추볶음', '큰멸치꽈리고추볶음', '표고버섯꽈리고추볶음', '피망고추볶음', '한치돈육고추볶음', '햄꽈리고추볶음', '홍진미풋고추볶음', '황태채고추볶음', '황태채꽈리고추볶음', '황태채풋고추볶음', '훈제떡갈비청양고추볶음', '훈제오리꽈리고추볶음']
감자볶음: ['닭감자볶음탕', '닭봉감자볶음탕', '매콤닭감자볶음탕']
콩나물밥: ['무콩나물밥양념장', '소고기콩나물밥과달래장', '쇠고기콩나물밥무밥', '콩나물밥과달래간장', '콩나물밥조식']
치즈김밥: ['김치치즈김밥튀김', '돈가스치즈김밥', '매콤치즈김밥', '볶아먹는치즈김밥', '불고기치즈김밥', '불닭치즈김밥', '셀프참치치즈김밥', '소세지치즈김밥', '소시지치즈김밥', '스팸말이치즈김밥', '스팸치즈김밥', '신전치즈김밥', '야채치즈김밥', '참치마요치즈김밥', '참치치즈김밥', '치즈김밥']
채소김밥: ['채소김밥']
참치김밥: ['참치김밥인가']
제육덮밥: ['숯불제육덮밥소스', '제육덮밥소', '토마토제육덮밥소스']
유부초밥: ['유부초밥토핑용']
완두콩밥: ['강황쌀완두콩밥', '병아리완두콩밥', '생완두콩밥', '압맥완두콩밥', '옥수수완두콩밥', '완두콩밥', '유기농완두콩밥', '찰칼슘완두콩밥', '찰현미완두콩밥', '찰흑미완두콩밥', '친환경기장완두콩밥', '친환경생완두콩밥', '친환경쌀완두콩밥', '친환경완두콩밥', '친환경찹쌀완두콩밥', '친환경햇완두콩밥', '친환경현미완두콩밥', '칼슘완두콩밥', '풋완두콩밥', '햇완두콩밥', '현미완두콩밥', '흑미완두콩밥']
순대국밥: ['고기순대국밥', '구수한돼지순대국밥', '꿀꿀돼지순대국밥', '돈등뼈순대국밥', '돈사골순대국밥', '돈수육순대국밥', '돈순대국밥', '돈육순대국밥', '돼지고기순대국밥', '돼지등뼈순대국밥', '돼지사골순대국밥', '돼지수육순대국밥', '돼지순대국밥', '돼지찹쌀순대국밥', '들깨수육순대국밥', '들깨순대국밥', '등뼈순대국밥', '따로돼지순대국밥', '따로순대국밥', '뚝배기모둠순대국밥', '뚝배기순대국밥', '맑은순대국밥', '매운순대국밥', '매콤모둠순대국밥', '매콤순대국밥', '머리고기순대국밥', '머릿고기순대국밥', '명품순대국밥', '모둠고기순대국밥', '모둠순대국밥', '모듬고기순대국밥', '모듬순대국밥', '미니고기순대국밥', '미니순대국밥', '백순대국밥', '병천순대국밥', '병천식순대국밥', '병천아우내순대국밥', '부산순대국밥', '부추순대국밥', '사골김치순대국밥', '사골돼지순대국밥', '사골순대국밥', '소고기순대국밥', '소머리순대국밥', '소문난순대국밥', '수육순대국밥', '수제순대국밥', '순대국밥', '순대국밥용', '시래기순대국밥', '신의주순대국밥', '신의주식순대국밥', '아바이순대국밥', '야채순대국밥', '얼큰고기순대국밥', '얼큰돼지순대국밥', '얼큰들깨순대국밥', '얼큰병천순대국밥', '얼큰사골순대국밥', '얼큰순대국밥', '얼큰콩나물순대국밥', '얼큰한순대국밥', '엄마손부추순대국밥', '옛날순대국밥', '옛날찰순대국밥', '옥포고순대국밥', '우거지순대국밥', '우사골머리고기순대국밥', '우사골순대국밥', '우사골순대국밥한사발', '원조장터순대국밥', '인삼순대국밥', '장터순대국밥', '전통순대국밥', '짬뽕순대국밥', '쭈꾸미순대국밥', '찰순대국밥', '찰진전통순대국밥', '청풍명월순대국밥', '콩나물돼지순대국밥', '콩나물순대국밥', '큰그릇순대국밥', '큰사발돼지고기순대국밥', '토리순대국밥', '토속순대국밥', '토종돼지순대국밥', '토종순대국밥', '토종찰순대국밥', '파송송순대국밥', '평양식순대국밥', '한그릇순대국밥', '한우머릿고기순대국밥', '한우사골순대국밥', '한우순대국밥', '한일순대국밥', '함경도순대국밥', '함경도식순대국밥', '호호토종순대국밥', '홍반장순대국밥']
낙지덮밥: ['낙지덮밥소스']
김치김밥: ['갓김치김밥', '경아김치김밥', '김치김밥', '누드참치김치김밥', '매운김치김밥', '모짜치즈김치김밥', '볶은김치김밥', '불고기김치김밥', '사각김치김밥', '오리훈제김치김밥한줄', '참치김치김밥', '참치샐러드김치김밥', '치즈김치김밥', '햄김치김밥', '햄치즈김치김밥']
고추김밥: ['고추김밥', '꼬마고추김밥', '쇠고기고추김밥', '청양고추김밥볶음밥']
검정콩밥: ['검정콩밥', '무농약검정콩밥', '밤검정콩밥', '조각검정콩밥', '차조검정콩밥', '찰검정콩밥', '찰현미검정콩밥', '친환경검정콩밥', '친환경쌀검정콩밥', '친환경조각검정콩밥', '친환경칼슘검정콩밥', '칼슘검정콩밥', '칼슘쏙쏙검정콩밥', '현미검정콩밥', '흑미검정콩밥']
쟁반국수: ['메밀쟁반국수무침']
잔치국수: ['잔치국수와양념장']
비빔냉면: ['비빔냉면양념장']
비빔국수: ['비빔국수양념장']
볶음우동: ['볶음우동오븐구이']
메밀국수: ['메밀국수야채무침']
떡만두국: ['떡만두국밥', '사골떡만두국한그릇', '새해맞이삼색옹심이떡만두국', '조랑떡만두국']
달걀라면: ['달걀라면한그릇']
김치만두: ['김치만두탕수']
고기만두: ['불고기만두라자냐', '쇠고기만두찜']
총각김치: ['총각김치재료']
오이김치: ['오이김치냉국', '파프리카오이김치담기']
열무김치: ['열무김치별도']
부추김치: ['부추김치무침']
보쌈김치: ['보쌈김치제공시']
배추김치: ['배추김치완제품']
나박김치: ['나박김치냉국', '비트나박김치담그기']
깻잎김치: ['깻잎김치찜']
홍합무국: ['건홍합무국', '다시마홍합무국', '맑은홍합무국', '시원한홍합무국', '얼큰홍합무국', '청양초홍합무국', '피홍합무국', '홍합무국']
콩나물국: ['맑은콩나물국물', '얼큰콩나물국물', '콩나물국냉국']
오징어국: ['갑오징어국', '김치오징어국', '꽃게오징어국', '나가사키오징어국', '두부오징어국', '마른오징어국', '맑은오징어국', '매운오징어국', '매콤오징어국', '무오징어국', '물만두오징어국', '물오징어국', '미나리오징어국', '미더덕오징어국', '새우물만두오징어국', '순두부오징어국', '시금치오징어국', '쑥갓오징어국', '양배추오징어국', '얼큰오징어국', '오징어국', '청경채오징어국', '콩나물오징어국', '풋고추오징어국', '호박오징어국']
오이냉국: ['오이냉국메밀면']
쑥된장국: ['감자쑥된장국', '건새우쑥된장국', '굴쑥된장국', '근대쑥된장국', '김치쑥된장국', '냉이쑥된장국', '단배추쑥된장국', '달래쑥된장국', '두부쑥된장국', '맑은쑥된장국', '바지락살쑥된장국', '바지락쑥된장국', '배추쑥된장국', '보리새우쑥된장국', '봄동쑥된장국', '봄쑥된장국', '시금치쑥된장국', '쑥된장국', '애쑥된장국', '얼갈이쑥된장국', '열무쑥된장국', '조갯살쑥된장국', '친환경두부쑥된장국', '콩가루냉이쑥된장국', '콩가루배추쑥된장국', '콩가루쑥된장국', '콩나물쑥된장국', '향긋한쑥된장국']
뼈해장국: ['돈등뼈해장국한빛']
미역냉국: ['미역냉국수']
메밀묵국: ['메밀묵국']
도가니탕: ['도가니탕', '동래도가니탕', '한우도가니탕']
꼬리곰탕: ['꼬리곰탕', '도가니꼬리곰탕', '소꼬리곰탕', '인삼꼬리곰탕', '한방꼬리곰탕', '한우꼬리곰탕', '한우도가니꼬리곰탕', '한우소꼬리곰탕']
쥐포구이: ['쥐포구이채조림']
조기구이: ['간조기구이', '국산참조기구이', '꼬마민어조기구이', '두절조기구이', '레몬순살참조기구이', '로즈마리참조기구이', '미니순살백조기구이', '민어조기구이', '바질향백조기구이', '백조기구이', '생조기구이', '소조기구이', '순살백조기구이', '순살조기구이', '순살참조기구이', '쌀가루조기구이', '애조기구이', '애플민트조기구이', '양념백조기구이', '영광순살조기구이', '오븐조기구이', '온마리조기구이', '잔조기구이', '저염조기구이', '제주조기구이', '조기구이', '참조기구이', '카레조기구이', '함초조기구이']
쇠불고기: ['쇠불고기부추볶음']
새우구이: ['버터새우구이꼬치']
삼치구이: ['삼치구이유자소스']
버섯구이: ['버섯구이샐러드']
닭발구이: ['무뼈닭발구이', '뼈없는닭발구이']
꽁치구이: ['꽁치구이양념장']
굴비구이: ['법성표굴비구이']
갈치구이: ['갈치구이양념']
팥찹쌀떡: ['수능응원단팥찹쌀떡', '쑥팥찹쌀떡', '통팥찹쌀떡', '팥찹쌀떡']
팥시루떡: ['동지팥시루떡', '찰팥시루떡', '팥시루떡', '호박팥시루떡']
찐옥수수: ['찐옥수수스프']
찐고구마: ['찐고구마단호박카나페']
모듬찰떡: ['모듬찰떡']
치킨까스: ['치킨까스칠리소스']
쥐포튀김: ['고구마쥐포튀김', '동전쥐포튀김', '줄쥐포튀김', '쥐포튀김']
양념치킨: ['양념치킨텐더']
생선까스: ['생선까스치폴레소스']
고추튀김: ['고추튀김만두', '오이고추튀김구이']
소갈비찜: ['궁중소갈비찜', '단호박소갈비찜', '동인동소갈비찜', '동인동식소갈비찜', '떡소갈비찜', '매운소갈비찜', '매콤낙지소갈비찜', '매콤소갈비찜', '매콤한우소갈비찜', '묵은지소갈비찜', '밤소갈비찜', '뿌리채소갈비찜', '소갈비찜', '영양소갈비찜', '웰빙소갈비찜', '전복소갈비찜', '전복한우소갈비찜', '한방소갈비찜', '한우소갈비찜', '한우영양소갈비찜']
문어숙회: ['돌문어숙회비빔밥', '문어숙회']
호박찌개: ['애호박찌개국']
버섯찌개: ['감자버섯찌개', '건새우버섯찌개', '고추장버섯찌개', '굴두부버섯찌개', '낙지버섯찌개', '냉이버섯찌개', '노루궁뎅이버섯찌개', '느타리버섯찌개', '닭고기버섯찌개', '닭매운버섯찌개', '닭살버섯찌개', '대패버섯찌개', '돈사태버섯찌개', '돈육버섯찌개', '돈육얼큰버섯찌개', '돈육호박버섯찌개', '돼지고기버섯찌개', '두부버섯찌개', '두부쇠고기버섯찌개', '들깨버섯찌개', '만두버섯찌개', '맑은버섯찌개', '맑은순두부버섯찌개', '매운두부버섯찌개', '매운두부팽이버섯찌개', '매운버섯찌개', '매운쇠고기버섯찌개', '매콤버섯찌개', '매콤소고기버섯찌개', '모둠버섯찌개', '모듬버섯찌개', '무항생제쇠고기버섯찌개', '민물새우버섯찌개', '버섯찌개', '불낙버섯찌개', '비건만두버섯찌개', '사골버섯찌개', '소고기모듬버섯찌개', '소고기버섯찌개', '소불고기버섯찌개', '손만두버섯찌개', '쇠고기두부버섯찌개', '쇠고기매운버섯찌개', '쇠고기모듬버섯찌개', '쇠고기버섯찌개', '수제비버섯찌개', '숙주버섯찌개', '순두부버섯찌개', '애느타리버섯찌개', '양송이버섯찌개', '얼갈이버섯찌개', '얼큰돈육버섯찌개', '얼큰들깨버섯찌개', '얼큰버섯찌개', '얼큰샤브버섯찌개', '얼큰소고기버섯찌개', '얼큰쇠고기버섯찌개', '얼큰한버섯찌개', '연두부버섯찌개', '영양버섯찌개', '오징어버섯찌개', '왕만두버섯찌개', '차돌박이버섯찌개', '참나물버섯찌개', '청국장버섯찌개', '친환경버섯찌개', '친환경한우버섯찌개', '팽이버섯찌개', '표고버섯찌개', '한우버섯찌개', '해물순두부버섯찌개', '햄버섯찌개', '호박버섯찌개', '황태버섯찌개']
두부전골: ['김치두부전골', '낙지두부전골', '낙지순두부전골', '두부전골', '맑은두부전골', '맑은버섯두부전골', '매운두부전골', '매콤두부전골', '모듬버섯두부전골', '버섯두부전골', '쇠고기두부전골', '야채당면칼슘두부전골', '얼큰두부전골', '한두부전골', '한우두부전골']
꽁치찌개: ['꽁치찌개']
김치찌개: ['김치찌개짜글이']
조기조림: ['고사리조기조림', '생고사리조기조림', '시래기참조기조림', '유채조기조림', '잔조기조림', '조기조림', '참조기조림']
북어조림: ['반건북어조림', '북어조림', '연북어조림']
동태조림: ['동태조림', '매운동태조림', '얼동태조림', '칼칼한동태조림']
고추조림: ['깐멸치꽈리고추조림', '어묵멸치풋고추조림']
미나리전: ['건새우미나리전', '건새우봄미나리전', '김치미나리전', '깻잎미나리전', '단호박미나리전', '돌미나리전', '맑은버섯미나리전골', '미나리전', '바지락미나리전', '베이컨미나리전', '보리새우미나리전', '봄향기가득새우살미나리전', '부추미나리전', '새우깡미나리전', '새우미나리전', '새우살미나리전', '생새우미나리전', '쇠고기미나리전', '애호박미나리전', '오징어미나리전', '해물미나리전', '해물부추미나리전', '햇감자미나리전', '호박미나리전', '홍합미나리전']
가자미전: ['가자미전', '순살가자미전']
낙지꼬지: ['매콤호롱낙지꼬지', '호롱낙지꼬지']
무장아찌: ['무장아찌삼색무침']
치즈피자: ['치즈피자소스', '콘치즈피자토스트']
해물볶음: ['해물볶음전']
순대볶음: ['백순대볶음양념장', '순대볶음덮밥']
두부김치: ['두부김치지짐']
해물덮밥: ['매콤해물덮밥한그릇', '중화풍해물덮밥소스', '해물덮밥소스']
충무김밥: ['충무김밥식어묵무침']
참치덮밥: ['고추참치덮밥밥']
장어초밥: ['장어초밥']
장어덮밥: ['힘이불끈통장어덮밥']
연어초밥: ['신박한연어초밥', '연어초밥', '연어초밥모양도넛', '훈제연어초밥']
송이덮밥: ['돼지고기양송이덮밥', '소고기양송이덮밥', '소불고기양송이덮밥', '쇠고기양송이덮밥', '양송이덮밥', '청경채양송이덮밥', '한우양송이덮밥']
새우초밥: ['새우초밥', '자숙새우초밥']
문어초밥: ['새우문어초밥']
홍어무침: ['홍어무침']
도토리묵: ['도토리묵참나물']
더덕무침: ['골뱅이더덕무침', '구운더덕무침', '낙지더덕무침', '달래더덕무침', '더덕무침', '밤더덕무침', '배더덕무침', '배밤더덕무침', '부추더덕무침', '북어채더덕무침', '브로콜리더덕무침', '사과더덕무침', '시금치더덕무침', '애느타리더덕무침', '오이더덕무침', '오징어더덕무침', '우렁살더덕무침', '진미더덕무침', '진미채더덕무침', '쭈꾸미더덕무침']
노각무침: ['고추장노각무침', '노각무침', '도라지노각무침', '매콤노각무침', '매콤달콤노각무침', '무말랭이노각무침', '미나리노각무침', '부추노각무침', '새콤노각무침', '아삭노각무침', '오이노각무침', '참외노각무침']
치즈라면: ['치즈라면사리']
짬뽕라면: ['고기짬뽕라면', '까르보짬뽕라면', '꼬꼬짬뽕라면', '꽃게짬뽕라면', '나가사끼짬뽕라면', '나가사키짬뽕라면', '닭살짬뽕라면', '대패삼겹살짬뽕라면', '대패짬뽕라면', '매콤짬뽕라면', '미니순두부짬뽕라면', '미니짬뽕라면', '미니해물짬뽕라면', '불맛짬뽕라면', '삼선짬뽕라면', '순두부짬뽕라면', '얼큰고기짬뽕라면', '얼큰짬뽕라면', '얼큰해물짬뽕라면', '오징어짬뽕라면', '육짬뽕라면', '짬뽕라면', '콩나물짬뽕라면', '파채짬뽕라면', '하얀짬뽕라면', '해물짬뽕라면', '해물통낙지짬뽕라면', '홍게짬뽕라면', '홍합짬뽕라면']
열무냉면: ['동치미열무냉면한그릇', '미니열무냉면', '비빔열무냉면', '시원한열무냉면', '열무냉면']
삼선짬뽕: ['낙지삼선짬뽕밥', '미니삼선짬뽕', '삼선짬뽕', '삼선짬뽕덮밥', '삼선짬뽕면', '얼큰삼선짬뽕']
닭칼국수: ['닭칼국수한그릇']
김치우동: ['김치우동볶이']
김치라면: ['김치라면찌개']
수수팥떡: ['수수팥떡']
무지개떡: ['무지개떡케이크']
메밀전병: ['김치메밀전병구이', '메밀전병구이']
고들빼기: ['고들빼기지제육볶']
난자완스: ['난자완스야채볶음', '중화풍한입매콤난자완스']
고추잡채: ['고추잡채말이아몬드강정']
무된장국: ['감자무된장국', '감자열무된장국', '건새우열무된장국', '나박무된장국', '낙지열무된장국', '단배추무된장국', '달래무된장국', '달래열무된장국', '돈육열무된장국', '두부무된장국', '두부열무된장국', '들깨무된장국', '들깨열무된장국', '들깨즙무된장국', '맑은무된장국', '매운열무된장국', '매콤열무된장국', '무된장국', '미역무된장국', '바지락살열무된장국', '바지락열무된장국', '배추무된장국', '배추열무된장국', '버섯무된장국', '보리새우열무된장국', '부여열무된장국', '소고기열무된장국', '솎음열무된장국', '쇠고기열무된장국', '시금치무된장국', '시래기무된장국', '시원한무된장국', '애열무된장국', '얼큰열무된장국', '열무된장국', '오만둥이열무된장국', '우렁이열무된장국', '유부무된장국', '저염열무된장국', '전통장열무된장국', '조개열무된장국', '조갯살두부열무된장국', '조갯살열무된장국', '친환경무된장국', '친환경열무된장국', '콩가루열무된장국', '콩나물무된장국', '콩나물열무된장국', '팽이무된장국', '팽이버섯무된장국']
훈제오리: ['훈제오리캠핑구이']
황태구이: ['버터황태구이', '황태구이']
병어구이: ['병어구이', '청파래포테이토병어구이']
더덕구이: ['고추장더덕구이', '눌린더덕구이', '더덕구이', '도라지더덕구이', '돼지고기더덕구이', '북어더덕구이', '삼겹살더덕구이', '새송이더덕구이', '예산더덕구이', '장어더덕구이', '큰송이더덕구이', '황태더덕구이']
탕수육: ['탕수육적채소스']
떡강정: ['떡강정치킨']
닭강정: ['닭강정샌드위치']
깐풍기: ['깐풍기부흥']
김튀김: ['고구마튀김튀김', '통통만김튀김']
아귀찜: ['꽃게아귀찜', '꽃게해물아귀찜', '대구살아귀찜', '두절콩나물아귀찜', '마라맛아귀찜', '마라아귀찜', '매콤순살아귀찜', '매콤아귀찜', '매콤한아귀찜', '모듬해물아귀찜', '미나리순살아귀찜', '미나리아귀찜', '미나리콩나물아귀찜', '미더덕아귀찜', '새우아귀찜', '순살아귀찜', '순살콩나물아귀찜', '순살해물아귀찜', '아귀찜', '주꾸미아귀찜', '콩나물꽃게아귀찜', '콩나물순살아귀찜', '콩나물아귀찜', '콩나물해물아귀찜', '튀겨먹는아귀찜', '튀긴아귀찜', '한입순살아귀찜', '해물순살아귀찜', '해물아귀찜', '해물콩나물아귀찜']
꼬막찜: ['꼬막찜양념장']
깻잎찜: ['깻잎찜양념무침']
추어탕: ['가을보양추어탕', '가을엔추어탕', '가을추어탕', '고등어추어탕', '기운찬추어탕', '꽁치추어탕', '남도식추어탕', '남원식추어탕', '든든추어탕', '들깨추어탕', '뜨덕손수제비추어탕', '맑은추어탕', '메기추어탕', '명태추어탕', '무시래기추어탕', '무청들깨추어탕', '무청시래기추어탕', '미꾸라지추어탕', '방아잎추어탕', '보양추어탕', '새알심추어탕', '서울식추어탕', '수제비추어탕', '수제추어탕', '시래기추어탕', '쌀수제비추어탕', '얼갈이추어탕', '얼큰고소추어탕', '얼큰추어탕', '영양듬뿍추어탕', '영양만점추어탕', '영양추어탕', '우렁이추어탕', '우렁추어탕', '입동맞이추어탕', '장어추어탕', '전라도식추어탕', '전통추어탕', '제철추어탕', '진한추어탕', '참치추어탕', '처서맞이추어탕', '체고추어탕', '추어탕', '칼슘가득추어탕', '콩가루추어탕', '키쑥쑥추어탕', '현천추어탕', '활장어수제비추어탕']
장어탕: ['기운찬통영장어탕', '들깨장어탕', '무시래기장어탕', '보양장어탕', '수제비장어탕', '시래기장어탕', '얼갈이장어탕', '얼큰장어탕', '여름보양식시래기장어탕', '영양듬뿍장어탕', '영양장어탕', '우거지장어탕', '장어탕', '장어탕수제비국', '정성듬뿍장어탕', '칼슘듬뿍장어탕', '통영시래기장어탕', '힘불끈장어탕']
오리탕: ['고구마대오리탕', '광주식들깨오리탕', '광주식오리탕', '깻잎오리탕', '들깨순살오리탕', '들깨영양오리탕', '들깨오리탕', '맑은오리탕', '머위대순살오리탕', '머위대오리탕', '머위오리탕', '몸에좋은한방오리탕', '무항생오리탕', '무항생제들깨오리탕', '무항생제매콤오리탕', '무항생제한방오리탕', '미나리오리탕', '보양오리탕', '부추들깨오리탕', '부추순살오리탕', '뼈없는오리탕', '사천오리탕수', '생생오리탕', '순살오리탕', '시원하고맛있는오리탕', '얼큰들깨오리탕', '얼큰오리탕', '영양부추오리탕', '영양오리탕', '오리탕', '전복오리탕', '죽순오리탕', '친환경오리탕', '토란대오리탕', '통들깨오리탕', '한방누룽지오리탕', '한방오리탕', '황기오리탕']
꽃게탕: ['꽃게탕수']
감자탕: ['감자탕한그릇', '남다른순살감자탕', '등뼈감자탕한그릇']
호박죽: ['호박죽파우치']
채소죽: ['게살채소죽', '닭고기채소죽', '닭다리장각채소죽', '닭채소죽', '대게살채소죽', '버섯채소죽', '삼색채소죽', '새우채소죽', '소고기버섯채소죽', '소고기채소죽', '쇠고기누룽지채소죽', '쇠고기채소죽', '영양채소죽', '전복채소죽', '조갯살채소죽', '참치채소죽', '채소죽', '친환경채소죽', '표고채소죽', '한우버섯채소죽', '한우쇠고기채소죽', '한우채소죽', '홍게살채소죽']
전복죽: ['소고기전복죽한그릇', '영양전복죽한그릇', '전복죽한그릇']
콩조림: ['땅콩검정콩조림', '연근검정콩조림']
무조림: ['돈육무조림덮밥', '돼지고기무조림덮밥', '무조림덮밥']
닭조림: ['눈꽃치즈닭조림덮밥', '닭조림덮밥', '바베큐닭조림덮밥']
채소전: ['갈비채소전골', '감자채소전', '감자채채소전', '게맛살채소전', '계란채소전', '고추채소전', '김치채소전', '꼬마고추채소전', '꼬막채소전', '꼬시래기채소전', '단호박채소전', '닭가슴살채소전', '당면채소전', '돈육채소전', '동태채소전', '돼지고기채소전', '두부채소전', '들깨버섯채소전골', '메밀채소전', '모듬채소전', '버섯채소전', '봄나물채소전', '부추채소전', '비트채소전', '생선살채소전', '소고기채소전', '소시지채소전골', '쇠고기채소전골', '수제애호박채소전', '수제어묵채소전', '수제옥수수채소전', '숙주베이컨채소전', '스팸채소전', '애호박감자채소전', '애호박채소전', '어묵채소전', '얼큰갈비채소전골', '연근채소전', '오징어김치채소전', '오징어채소전', '옥수수알채소전', '옥수수채소전', '직접만든햄두부채소전', '참치채소전', '채소전', '카레채소전', '콩국채소전', '크래미채소전', '팽이달걀채소전', '팽이버섯채소전', '포도씨유콩국채소전', '표고버섯채소전', '하트채소전', '해물채소전', '햄채소전', '호박채소전']
부추전: ['방아해물부추전', '호박부추전']
메밀전: ['메밀전병비빔면']
맛살전: ['맛살전과']
떡갈비: ['떡갈비스테이크샐러드']
김치전: ['김치전병', '매콤김치전병', '메밀김치전병', '미니김치전병']
감자전: ['감자전양념무침']
가지전: ['가지전부추겨자소스']
치킨무: ['치킨무초절이']
오이지: ['오이지배무침']
무짠지: ['무짠지채무침']
단무지: ['단무지채맛살무침']
팥빙수: ['팥빙수아이스크림']
회무침: ['갑오징어미나리회무침', '갑오징어숙회무침', '갑오징어회무침', '곤약회무침', '꼬막야채회무침', '낙지미나리회무침', '낙지회무침', '도라지오징어회무침', '돌나물오징어회무침', '두릅회무침', '문어무회무침', '문어숙회무침', '문어시금치회무침', '미나리오징어회무침', '바지락회무침', '반고개회무침', '반지락회무침', '북어포회무침', '브로콜리회무침', '새꼬막회무침', '새송이회무침', '소라회무침', '애호박회무침', '어묵회무침', '오징어무미나리회무침', '오징어무숙회무침', '오징어무회무침', '오징어미나리숙회무침', '오징어미나리회무침', '오징어숙회무침', '오징어시금치회무침', '오징어죽순회무침', '오징어회무침', '주꾸미숙회무침', '죽순회무침', '쪽파강회무침', '쪽파숙회무침', '쭈꾸미회무침', '풋마늘오징어회무침', '한치오징어숙회무침', '한치회무침', '홍어회무침', '황태채회무침']
파무침: ['깐멸치파무침', '백오이양파무침', '새콤달콤양파무침과무쌈', '오이부추잔파무침', '쥐채양파무침', '파래자반쪽파무침무침', '파무침닭']
양장피: ['양장피무침']
무생채: ['무생채톳무침']
김무침: ['김무침밥']
햄버거: ['햄버거스테이크']
피자빵: ['파프리카피자빵신', '피자빵오븐구이']
츄러스: ['츄러스크림']
베이글: ['베이글크림브륄레']
모카빵: ['모카빵', '소보로모카빵', '우리밀모카빵']
모닝빵: ['모닝빵수제샌드위치']
마늘빵: ['마늘빵조각']
링도넛: ['구운링도넛', '글레이즈링도넛', '글레이즈미니링도넛', '글레이즈초코링도넛', '꼬마링도넛', '다크링도넛', '다크초코링도넛', '다크프렌즈링도넛', '던킨레인보우초코링도넛', '던킨미니링도넛', '던킨미니초코링도넛', '던킨초코링도넛', '던킨쵸코링도넛', '던킨쿠키링도넛', '던킨필링도넛', '딸기링도넛', '딸기맛필링도넛', '딸기찰링도넛', '딸기초코링도넛', '딸기필링도넛', '딸기향링도넛', '라즈베리필링도넛', '레드쿠키링도넛', '레인보우링도넛', '레인보우초코링도넛', '링도넛', '마블초코링도넛', '맛있는링도넛', '메이플링도넛', '미니딸기링도넛', '미니레인보우링도넛', '미니링도넛', '미니찰링도넛', '미니초코링도넛', '미니핑크링도넛', '미니핑크초코링도넛', '미니화이트링도넛', '미니화이트케익링도넛', '미니화이트쿠키링도넛', '바나나링도넛', '바나나맛링도넛', '바나나케익링도넛', '바바리안필링도넛', '반짝반짝링도넛', '벗꽃찰링도넛', '벚꽃링도넛', '벚꽃찰링도넛', '벚꽃초코링도넛', '벚꽃츄링도넛', '베리필링도넛', '부드러운링도넛', '부드러운필링도넛', '블랙라즈베리필링도넛', '블루베리필링도넛', '쁘띠구운링도넛', '생크림미니링도넛', '샤워크림링도넛', '소보루찰링도넛', '소프트초코링도넛', '수제링도넛', '수제블루베리필링도넛', '슈가링도넛', '스트로베리필링도넛', '우리밀링도넛', '우리밀초코링도넛', '우리밀쵸코링도넛', '우리쌀쫀득찰링도넛', '우리쌀찰링도넛', '우리쌀초코찰링도넛', '유기농초코찰링도넛', '쫀득찰링도넛', '쫄깃링도넛', '쫄깃쫄깃링도넛', '찰링도넛', '찹쌀링도넛', '초코링도넛', '초코맛링도넛', '초코미니링도넛', '초코바나나링도넛', '초코찰링도넛', '초코츄이링도넛', '초코타르트링도넛', '초코폰데링도넛', '초코프렌즈링도넛', '초코화이트링도넛', '쵸코링도넛', '쵸코찰링도넛', '츄이링도넛', '치킨링도넛', '칠링도넛', '카카오링도넛', '코코넛링도넛', '코코넛초코링도넛', '콩고물미니찰링도넛', '콩고물찰링도넛', '쿠키링도넛', '크런치링도넛', '크리스마스찰링도넛', '통밀링도넛', '프렌즈링도넛', '플라워링도넛', '필링도넛', '핑크링도넛', '핑크미니링도넛', '핑크초코링도넛', '하프마블초코링도넛', '허쉬초코링도넛', '화이트링도넛', '화이트미니링도넛', '화이트초코링도넛', '화이트쿠키링도넛', '화이트프렌즈링도넛', '후르트링도넛']
꽈배기: ['꽈배기어묵꼬치국']
팔보채: ['팔보채덮밥소스']
유산슬: ['유산슬밥']
라볶이: ['까르보마라볶이', '라볶이한그릇']
떡볶이: ['떡볶이에']
닭볶음: ['닭볶음찜', '불닭볶음덮밥']
흑미밥: ['흑미밥라이스아이스크림']
현미밥: ['가바쌀현미밥', '발아찰현미밥', '발효누룽현미밥', '싹틔운현미밥', '쌀눈가득현미밥', '오분도현미밥', '자색현미밥', '찰녹색현미밥', '찰현미밥공']
차조밥: ['차조밥부흥']
짬뽕밥: ['고기짬뽕밥', '꼬꼬짬뽕밥', '나가사끼짬뽕밥', '닭안심짬뽕밥', '돈육중화볶음짬뽕밥', '돈육직화짬뽕밥', '미니짬뽕밥', '백짬뽕밥', '볶음짬뽕밥', '불짬뽕밥', '비빔짬뽕밥', '삼선짬뽕밥', '삼선해물짬뽕밥', '순두부짬뽕밥', '순두부해물짬뽕밥', '숯불고기짬뽕밥', '숯불불고기볶음짬뽕밥', '얼큰고기짬뽕밥', '얼큰짬뽕밥', '얼큰해물짬뽕밥', '오징어짬뽕밥', '이비가고기짬뽕밥', '이비가짬뽕밥', '중화돈육짬뽕밥', '중화볶음짬뽕밥', '중화짬뽕밥', '직화짬뽕밥한그릇', '짬뽕밥', '차돌짬뽕밥', '해물모듬짬뽕밥', '해물수제비짬뽕밥', '해물순두부짬뽕밥', '해물짬뽕밥', '해산물짬뽕밥', '홍합육짬뽕밥한그릇', '홍합짬뽕밥한그릇']
짜장밥: ['짜장밥계란치즈']
잡채밥: ['잡채밥소스']
잡곡밥: ['잡곡밥미니', '찰옥수수잡곡밥']
수수밥: ['무농약찰옥수수밥', '수수밥부흥', '옥수수밥산', '찹쌀현미옥수수밥', '친환경쌀찰옥수수밥', '친환경찰옥수수밥', '칼슘찹쌀옥수수밥', '통밀차조수수밥']
비빔밥: ['비빔밥에']
볶음밥: ['볶음밥용']
보리밥: ['보리밥과강된장', '찰보리밥미니']
기장밥: ['칼슘기장밥']
콩국수: ['간단콩국수', '검정콩국수', '고소한콩국수', '구수한냉콩국수', '국산콩국수', '냉콩국수', '두부콩국수', '미니냉콩국수', '미니메밀콩국수', '미니콩국수', '서리태검정콩국수', '서리태콩국수', '수제콩국수', '시원콩국수', '여름냉콩국수', '여름우리콩국수', '여름콩국수', '우리콩국수', '우뭇가사리콩국수', '진한콩국수', '콩국수', '콩국수한그릇', '해초콩국수', '흑임자콩국수']
칼국수: ['칼국수용']
짜장면: ['짜장면케익']
월남쌈: ['월남쌈채소']
수제비: ['수제비트바나나쥬스']
물만두: ['물만두부추국']
물냉면: ['물냉면한그릇']
막국수: ['막국수야채무침']
떡라면: ['떡라면전골']
군만두: ['군만두소스볶음']
간짜장: ['간짜장채소볶음']
파김치: ['양파김치함박', '쪽파김치겉절이', '파김치담그기']
백김치: ['백김치양념무침']
동치미: ['동치미육수냉면']
깍두기: ['깍두기여']
갓김치: ['갓김치오일스파게티']
토란국: ['감자토란국', '고소한토란국', '굴토란국', '닭고기토란국', '들깨감자토란국', '들깨쇠고기토란국', '들깨토란국', '버섯토란국', '새우살알토란국', '소고기들깨토란국', '소고기알토란국', '소고기토란국', '쇠고기알토란국', '쇠고기토란국', '알토란국', '어묵토란국', '추석토란국', '토란국', '한우토란국']
조갯국: ['냉이조갯국', '두부조갯국', '모시조갯국', '바지락조갯국', '시금치조갯국', '아욱조갯국', '조갯국', '콩나물조갯국']
재첩국: ['재첩국완']
육개장: ['육개장부흥']
어묵국: ['니모빠진어묵국', '어묵국수']
순댓국: ['순댓국한그릇']
설렁탕: ['설렁탕한그릇']
새우탕: ['새우탕수조림']
삼계탕: ['삼계탕케이크']
사골국: ['사골국밥']
북엇국: ['감자북엇국', '계란북엇국', '김치북엇국', '달걀북엇국', '대파북엇국', '두부북엇국', '들깨북엇국', '맑은감자북엇국', '맑은북엇국', '매운북엇국', '무채북엇국', '미역북엇국', '북엇국', '사골북엇국', '순두부북엇국', '시원한북엇국', '얼갈이북엇국', '얼큰북엇국', '얼큰콩나물북엇국', '왕교자만두북엇국', '저염북엇국', '콩나물북엇국', '팽이버섯북엇국', '황태계란북엇국', '황태북엇국']
미역국: ['미역국수새콤무침']
동태국: ['동태국맑은국']
닭곰탕: ['닭곰탕당면국', '닭곰탕큰그릇']
닭개장: ['닭개장왕만둣국']
달걀국: ['감자달걀국', '감자옹심이달걀국', '감자채달걀국', '건새우감자달걀국', '건새우달걀국', '건표고달걀국', '건표고부추달걀국', '게맛살달걀국', '게살달걀국', '게살순두부달걀국', '게살표고달걀국', '굴림만두달걀국', '김가루달걀국', '김달걀국', '깐새우달걀국', '깻잎달걀국', '꼬지어묵달걀국', '꽃게꼬지어묵달걀국', '노가리달걀국', '느타리버섯달걀국', '다시마달걀국', '달걀국', '달걀국수', '닭고기달걀국물덮밥', '닭달걀국', '닭살달걀국', '대게살달걀국', '대왕만두떡달걀국', '대파달걀국', '대파버섯달걀국', '두부건새우달걀국', '두부달걀국', '두부부추달걀국', '들기름북어달걀국', '등급달걀국', '딤섬달걀국', '떡국떡달걀국', '라면달걀국', '만두달걀국', '만두황태달걀국', '맑은달걀국', '맑은순두부달걀국', '맑은양파달걀국', '맛살달걀국', '맛살애호박달걀국', '매운달걀국', '매콤달걀국', '명란달걀국', '명란순두부달걀국', '모듬어묵달걀국', '몽글달걀국', '몽글몽글달걀국', '몽글순두부달걀국', '물만두달걀국', '미니달걀국', '미니만두달걀국', '미니부추달걀국', '미역달걀국', '바지락달걀국수', '바지락부추달걀국', '배추달걀국', '버섯달걀국', '버섯황태달걀국', '벚꽃만두달걀국', '복만두달걀국', '부여표고부추달걀국', '부추달걀국', '부추물만두달걀국', '부추버섯달걀국', '부추양파달걀국', '부추팽이달걀국', '북어감자달걀국', '북어달걀국', '북어두부달걀국', '북어무달걀국', '북어부추달걀국', '북어어묵달걀국', '북어채달걀국', '북어채두부달걀국', '북어채순두부달걀국', '북어콩나물달걀국', '북어포달걀국', '북어포두부달걀국', '북어포무달걀국', '빨간달걀국', '삼색달걀국', '삼색옹심이감자달걀국', '삼색옹심이달걀국', '새송이달걀국', '새알만두달걀국', '새알심만두달걀국', '새우누룽지달걀국', '새우달걀국', '새우부추달걀국', '새우살달걀국', '새우살순두부달걀국', '새우연두부달걀국', '새우젓달걀국', '색만두달걀국', '생새우달걀국', '소파달걀국', '쇠고기달걀국', '쇠고기두부달걀국', '쇠고기맑은달걀국', '수교자만두달걀국', '순두부달걀국', '순두부북어달걀국', '시금치달걀국', '시금치북어달걀국', '실파달걀국', '실파쏭쏭달걀국', '알새우달걀국', '애호박달걀국', '야채달걀국', '양배추달걀국', '양송이달걀국', '양파달걀국', '어묵달걀국', '얼갈이달걀국', '얼큰달걀국', '얼큰북어달걀국', '얼큰양배추달걀국', '연두부달걀국', '연두부실파달걀국', '옹심이달걀국', '왕만두달걀국', '우리콩유부달걀국', '유부달걀국', '잔파달걀국', '장미만두달걀국', '조랭이떡달걀국', '종합어묵달걀국', '중국식달걀국', '쪽파달걀국', '채소달걀국', '청경채달걀국', '청경채표고달걀국', '청량달걀국', '청양달걀국', '친환경북어달걀국', '친환경팽이버섯달걀국', '친환경표고부추달걀국', '칼슘두부달걀국', '콩나물달걀국', '콩나물부추달걀국밥', '크래미달걀국', '토마토달걀국', '파달걀국', '파송송달걀국', '팽이달걀국', '팽이버섯달걀국', '팽이버섯부추달걀국', '팽이부추달걀국', '표고감자달걀국', '표고달걀국', '표고버섯달걀국', '표고버섯부추달걀국', '표고부추달걀국', '한우소고기무달걀국', '해물달걀국', '호박달걀국', '호박채달걀국', '홍합달걀국', '황태감자달걀국', '황태건새우달걀국', '황태달걀국', '황태두부달걀국', '황태실채달걀국', '황태채달걀국']
김칫국: ['김칫국', '꼬치어묵김칫국', '닭고기김칫국', '대구김칫국', '돈뼈김칫국', '돈육김칫국', '돈육콩나물김칫국', '동태살김칫국', '두부김칫국', '등뼈김칫국', '맑은김칫국', '매콤김칫국', '멸치김칫국', '모듬햄김칫국', '무채김칫국', '바지락김칫국', '바지락살김칫국', '버섯김칫국', '북어김칫국', '북어콩나물김칫국', '비엔나김칫국', '새알만두김칫국', '소고기김칫국', '숙주김칫국', '순두부김칫국', '순두부콩나물김칫국', '어묵김칫국', '얼큰김칫국', '얼큰콩나물김칫국', '얼큰한김칫국', '연두부김칫국', '열무김칫국', '오징어김칫국', '옹심이김칫국', '유부김칫국', '유부주머니김칫국', '참치김칫국', '친환경김칫국', '친환경두부김칫국', '콩가루김칫국', '콩나물김칫국', '콩나물두부김칫국', '햄김칫국', '황태김칫국', '후랑크김칫국']
굴무국: ['굴무국', '맑은굴무국', '매생이굴무국', '시원한굴무국']
감잣국: ['감잣국', '다시마감잣국', '달걀감잣국', '닭고기감잣국', '맑은감잣국', '부추감잣국', '북어감잣국', '북어채감잣국', '소고기감잣국', '쇠고기감잣국', '순두부감잣국', '시금치감잣국', '애호박감잣국', '양파감잣국', '어묵감잣국', '얼갈이감잣국', '한우감잣국', '호박감잣국', '호박잎감잣국', '황태감잣국', '황태채감잣국']
갈비탕: ['갈비탕소스', '돼지갈비탕소스', '바쿠테돼지갈비탕', '인삼한우갈비탕', '전복갈비탕한그릇', '한우갈비탕한그릇']
햄구이: ['햄구이한판']
조미김: ['조미김가루밥']
닭구이: ['매콤닭구이샌드위치', '불닭구이밥버그']
찐감자: ['찐감자버터구이']
인절미: ['인절미연유크로플']
쑥절편: ['미니쑥절편', '봄쑥절편', '쑥절편', '쑥절편과바람떡', '앙고쑥절편', '앙금쑥절편', '콩가루쑥절편', '콩고물쑥절편', '팥소앙금쑥절편']
백설기: ['백설기데이']
깨송편: ['깨송편', '단호박깨송편', '모듬깨송편', '모시깨송편', '복주머니모양깨송편', '삼색깨송편', '삼색참깨송편', '색깨송편', '쑥깨송편', '영광모시참깨송편', '오색깨송편', '우리쌀깨송편', '참깨송편', '하얀깨송편', '호두모양깨송편', '흑미깨송편']
가래떡: ['가래떡소시지구이']
매작과: ['매작과']
북어포: ['북어포배추국']
대구포: ['대구포커틀렛']
닭튀김: ['닭튀김시즈닝무침']
해물탕: ['해물탕수']
전복탕: ['닭장각전복탕', '반계전복탕', '어묵전복탕', '영계전복탕', '한우소갈비전복탕']
연포탕: ['낙지배추연포탕', '낙지버섯연포탕', '낙지연포탕', '닭살연포탕', '맑은낙지연포탕', '맑은연포탕', '매콤낙지연포탕', '문어연포탕', '미나리낙지연포탕', '소고기연포탕', '쇠고기낙지연포탕', '쇠고기연포탕', '순두부낙지연포탕', '순두부연포탕', '순두부한우연포탕', '시원한연포탕', '얼큰낙지연포탕', '얼큰연포탕', '연포탕', '전복낙지연포탕', '전복연포탕', '주꾸미연포탕', '쭈꾸미연포탕', '쭈낙연포탕', '청경채연포탕', '청량연포탕', '청양연포탕', '한우낙지연포탕', '해물낙지연포탕', '홍합연포탕', '황태연포탕']
아구탕: ['맑은순살아구탕', '맑은아구탕', '아구탕']
낙지탕: ['갈비낙지탕', '낙지탕', '두부낙지탕국', '밀국낙지탕', '바지락낙지탕', '불고기낙지탕', '소고기낙지탕', '쇠고기낙지탕', '순두부낙지탕', '얼큰낙지탕', '우불낙지탕', '한우갈비낙지탕', '한우낙지탕']
해물찜: ['해물찜닭']
조기찜: ['고사리조기찜', '조기찜']
아구찜: ['마산아구찜', '매콤순살아구찜', '매콤아구찜', '순살아구찜', '아구찜', '콩나물아구찜', '해물아구찜']
북어찜: ['닭북어찜']
동태찜: ['동태찜', '미더덕동태찜', '콩나물동태찜']
대구찜: ['대구찜갈비']
참치죽: ['야채참치죽', '참치죽']
게살죽: ['게살죽', '계란게살죽', '대게살죽', '붉은대게살죽', '영양게살죽', '울진대게살죽', '참치게살죽']
화양적: ['오색화양적', '화양적']
호박전: ['노란단호박전', '호박전무침']
햄부침: ['계란햄부침', '구프랑햄부침', '깻잎햄부침', '네모햄부침', '달걀햄부침', '동그란햄부침', '동그랑햄부침', '라운드햄부침', '마늘슬라이스햄부침', '부추슬라이스햄부침', '비건동그랑햄부침', '비건햄부침', '살코기햄부침', '스모크햄부침', '스팸햄부침', '슬라이스햄부침', '식물성햄부침', '애호박햄부침', '우리팜라운드햄부침', '우리팜햄부침', '햄부침']
야채전: ['버섯야채전골', '햄야채전골']
버섯전: ['감자버섯전', '감자채팽이버섯전', '감자팽이버섯전', '검정깨팽이버섯전', '게맛살새송이버섯전', '게맛살팽이버섯전', '게살팽이버섯전', '계란버섯전', '계란팽이버섯전', '낙지버섯전', '느타리버섯전', '당면팽이버섯전', '동충하초버섯전', '두릅버섯전', '두부버섯전', '땡초느타리버섯전', '땡초팽이버섯전', '맛살과팽이버섯전', '맛살모듬버섯전', '맛살버섯전', '맛살부추버섯전', '맛살팽이버섯전', '매생이팽이버섯전', '명란팽이버섯전', '모둠버섯전', '모듬버섯전', '미나리버섯전', '미나리부추베지미트버섯전', '미나리팽이버섯전', '바삭애느타리버섯전', '방풍버섯전', '버섯전', '베이컨달걀버섯전', '베이컨팽이버섯전', '분홍소시지버섯전', '브로콜리버섯전', '새송버섯전', '새송이버섯전', '새우느타리버섯전', '새우살단호박느타리버섯전', '새우살팽이버섯전', '쇠고기버섯전골탕', '수제두부버섯전', '수제버섯전', '수제팽이버섯전', '쑥버섯전', '아삭양파버섯전', '애느타리버섯전', '애호박버섯전', '애호박새우살버섯전', '애호박팽이버섯전', '야채버섯전', '어묵팽이버섯전', '영양모듬버섯전', '오꼬노미버섯전', '오징어버섯전', '옥수수버섯전', '옥수수콘버섯전', '참나물버섯전', '참치버섯전', '참치팽이버섯전', '참타리버섯전', '청양팽이버섯전', '친환경느타리버섯전', '친환경새송이버섯전', '카레버섯전', '카레새우살팽이버섯전', '크래미버섯전', '크래미팽이버섯전', '크레미팽이버섯전', '파래팽이버섯전', '파팽이버섯전', '팽이맛살버섯전', '팽이버섯전', '한우버섯전골찌개', '해물버섯전', '해물새송이버섯전', '햄버섯전', '햄쪽파버섯전', '호박버섯전', '황금팽이버섯전']
배추전: ['감자양배추전', '건새우알배추전', '게맛살양배추전', '계란양배추전', '김치양배추전', '단배추전', '달걀양배추전', '담백고소배추전', '돼지고기양배추전', '두부배추전골', '두툼양배추전', '맑은배추전골', '맑은샤브샤브배추전골', '메밀배추전', '메밀통배추전', '무배추전', '무전과배추전', '미니배추전', '바지락배추전골', '배추전', '버섯배추전골', '베이컨양배추전', '봄동배추전', '불고기양배추전', '소고기배추전골', '쇠고기배추전골', '수제배추전', '수제오꼬노미양배추전', '실파배추전', '쌈배추전', '아삭배추전', '알배기배추전', '알배추전', '양배추전', '오징어양배추전', '참치양배추전', '청양초배추전', '치즈양배추전', '한우배추전골', '해물배추전', '해물베이컨양배추전', '해물양배추전']
두부전: ['달고기두부전오꼬노미', '두부전부침', '매콤어두부전조림', '명태살두부전조림', '어두부전피자']
동태전: ['동태전참나물전']
깻잎전: ['깻잎전과']
고추전: ['고추전튀김', '반쪽고추전튀김']
수정과: ['수정과음료']
곰보빵: ['곰보빵']
회덮밥: ['숙회덮밥', '오징어숙회덮밥', '참치회덮밥']
잡탕밥: ['잡탕밥', '해물잡탕밥']
자장밥: ['자장밥소소']
오곡밥: ['친환경오곡밥']
탕평채: ['삼색탕평채묵채국', '탕평채무침']
쥐치채: ['쥐치채땅콩볶음']
자장면: ['자장면용']
쌀국수: ['쌀국수야채볶음']
기스면: ['기스면']
굴짬뽕: ['굴짬뽕', '굴짬뽕면', '나가사끼굴짬뽕', '해물굴짬뽕', '홍합굴짬뽕']
간자장: ['간자장소스']
찹쌀떡: ['찹쌀떡세트']
시루떡: ['시루시루떡']
콩나물: ['콩나물크래미무침']
취나물: ['취나물잣소스무침']
라조기: ['라조기순살치킨']
순대국: ['순대국양념장']
만두국: ['굴림달걀만두국', '만두국밥', '얼큰장왕만두국', '왕만두국부흥']
김치국: ['김치국수무침']
굴국밥: ['굴국밥', '매생이굴국밥']
닭꼬치: ['닭꼬치치즈오븐구이']
닭갈비: ['닭갈비양념떡조림']
족발: ['족발상추양파겉절이']
순대: ['순대소시지막창볶음']
닭찜: ['닭찜당면덮밥', '불닭찜닭', '순살안동식닭찜']
알탕: ['대구곤지알탕', '대구알탕찌개', '동태곤이알탕', '동태알탕찌개', '얼큰알탕찌개']
팥죽: ['팥죽보다']
닭죽: ['닭죽포함']
호떡: ['꿀호떡피자', '호떡샌드위치']
찐빵: ['안흥새싹순보리찐빵', '안흥흑미찐빵']
식빵: ['식빵야채튀김']
머핀: ['머핀위에', '잉글리쉬머핀샌드위치']
도넛: ['던킨도넛파파베어', '도넛스틱']
잡채: ['잡채어묵곤약조림']
팥밥: ['팥밥부흥']
찰밥: ['생일오색찰밥', '영양찰밥과', '친환경오곡찰밥']
알밥: ['알밥주먹밥']
무밥: ['무밥과', '쇠고기무밥과']
김밥: ['김밥쌈']
쫄면: ['쫄면파래곤약무침']
짬뽕: ['짬뽕순두부']
만두: ['만두야채국']
라면: ['라면샐러드']
떡국: ['떡국장']
곰탕: ['곰탕용']
증편: ['방울증편떡', '증편떡', '컵증편떡']
약식: ['약식오절판', '영양약식떡']
꿀떡: ['꿀떡꿀떡']
유과: ['우유과즙', '유과랑']
약과: ['약과와']
산자: ['국산자숙문어', '참산자']
육탕: ['돈육탕수강정']
어탕: ['문어탕수소스', '오징어탕수']
소탕: ['모듬채소탕수', '비건채소탕수', '중국식채소탕수']
잣죽: ['닭잣죽', '영양잣죽', '영양호두잣죽', '잣죽', '흑임자잣죽']
깨죽: ['들깨죽순나물']
파전: ['파전군교자']
굴전: ['감자채굴전', '굴전', '김치굴전골', '달래굴전', '매생이굴전', '물파래굴전', '버섯굴전', '실파굴전', '채소굴전', '파래굴전', '팽이버섯굴전', '해물굴전']
식혜: ['밥알이있는식혜', '식혜쥬스', '유기농우리쌀식혜']
만주: ['왕만주빵', '우리밀만주빵']
울면: ['울면한그릇']
절편: ['절편맛탕']
쑥떡: ['모찌팥쑥떡숙', '쑥떡쑥떡', '찰앙금쑥떡', '팥쑥떡쑥떡']
탕국: ['마라탕국수']